Office Goose
An Interactive Fiction by Lizzard
Release 11 / Serial number 191231 / Inform 7 build 6M62 (I6/v6.33 lib 6/12N) SD
It's a beautiful day in the office, and you are a horrible goose.
(If you aren't sure how to play, type "help" and hit enter.)

Open-plan office
You're in a large open room. Narrow corridors run between grey-walled cubicles. Exits lead east, west, and south.

You can see a potted palm and a printer here.

>drink
What do you want to drink?

>e
You must name something more substantial.

>drink coffee
You can't see any such thing.

* * *

Office Goose
An Interactive Fiction by Lizzard
Release 11 / Serial number 191231 / Inform 7 build 6M62 (I6/v6.33 lib 6/12N) SD
It's a beautiful day in the office, and you are a horrible goose.
(If you aren't sure how to play, type "help" and hit enter.)

Open-plan office
You're in a large open room. Narrow corridors run between grey-walled cubicles. Exits lead east, west, and south.

You can see a potted palm and a printer here.

>e
You waddle over with deadly purpose.

Office kitchen
This mini kitchen has tasty snacks and bad coffee. The main office is just to the west.

You can see a pod-based coffee maker, a sink, a cabinet (closed), and a purple-haired developer here.

>eat developer
Quite a challenge. You could try pecking or biting though.

* * *

>e
You waddle over with deadly purpose.

Office kitchen
This mini kitchen has tasty snacks and bad coffee. The main office is just to the west.

You can see a pod-based coffee maker, a sink, a cabinet (closed), and a purple-haired developer here.

>look developer
The purple-haired developer is carrying a cup of coffee.

>peck cup
You jab your beak at the cup of coffee.

Hot coffee spills all over the developer. She yells and drops the cup.

* * *

>e
You waddle over with deadly purpose.

Office kitchen
This mini kitchen has tasty snacks and bad coffee. The main office is just to the west.

You can see a pod-based coffee maker, a sink, a cabinet (closed), and a purple-haired developer here.

>look sink
A gleaming, tidy sink.

The sink is currently switched off.

>look developer
The purple-haired developer is carrying a cup of coffee.

>x coffee
(the pod-based coffee maker)
This sturdy machine is ready to make you a bitter cup of plastic swill.

The pod-based coffee maker is currently switched off.

(You feel a mighty primal urge to honk, to flap, and to peck things.)

>honk
HONK!!!!

Startled, a hapless office worker looks up in alarm.

>flap
You flap your wings, menacing everything in the near vicinity.

Everyone in the room starts in surprise.

>peck
What do you want to peck?

>coffee maker
You jab your beak at the pod-based coffee maker.
The pod-based coffee maker switches on.

Coffee sprays out of the coffee maker!

"Horrible goose," yells the developer, chasing you.

[Your score has just gone up by one point.]

>l
Office kitchen
This mini kitchen has tasty snacks and bad coffee. The main office is just to the east.

You can see puddles of spilled coffee, a pod-based coffee maker, a sink, and a purple-haired developer here.

"Catch it," yells the developer. She trips and falls over, swearing.

>drink coffee
Which do you mean, puddles of spilled coffee, the pod-based coffee maker, or the cup of coffee?

>puddles
There's nothing suitable to drink here.

"Nnnnnnggggg," yells the developer.

>eat puddle
You can't see any such thing.

>l
Office kitchen
This mini kitchen has tasty snacks and bad coffee. The main office is just to the east.

You can see puddles of spilled coffee, a pod-based coffee maker, a sink, and a purple-haired developer here.

"Horrible goose," yells the developer, chasing you.

>eat puddles
(first taking puddles of spilled coffee)
You jab your beak at it.

You eat puddles of spilled coffee. Not bad.

"Horrible goose," yells the developer, chasing you.

* * *

>e
You waddle over with deadly purpose.

Office kitchen
This mini kitchen has tasty snacks and bad coffee. The main office is just to the west.

You can see a pod-based coffee maker, a sink, a cabinet (closed), and a purple-haired developer here.

>peck coffee
(the pod-based coffee maker)
You jab your beak at the pod-based coffee maker.
The pod-based coffee maker switches on.

Coffee sprays out of the coffee maker!

[Your score has just gone up by one point.]

>peck cup
You jab your beak at the cup of coffee.

Hot coffee spills all over the developer. She yells and drops the cup.

* * *

>e
You waddle over with deadly purpose.

Office kitchen
This mini kitchen has tasty snacks and bad coffee. The main office is just to the west.

You can see a pod-based coffee maker, a sink, a cabinet (closed), and a purple-haired developer here.

>peck coffee maker
You jab your beak at the pod-based coffee maker.
The pod-based coffee maker switches on.

Coffee sprays out of the coffee maker!

"Horrible goose," yells the enraged developer, chasing you.

[Your score has just gone up by one point.]

>peck sink
You jab your beak at the sink.
The sink switches on.

The faucet cracks. Water sprays all over!

You notice a little red box halfway up the wall. It's a fire alarm.

"Catch it," yells the enraged developer. She trips over you, swearing.

[Your score has just gone up by one point.]

>peck alarm
You jab your beak at the fire alarm.
The fire alarm switches on.

The glass covering the fire alarm switch breaks.
ooooooOOOOOOooooooo!
The developer panics, opens a cupboard and takes out a fire extinguisher.

You feel a mighty primal urge to honk, to flap, and to peck things.
You notice a little red box halfway up the wall. It's a fire alarm.
oooooOOOOOOoooooo BEEP BEEP BEEP
"Nnnnnnggggg," yells the enraged developer. She flails, knocking her own glasses onto the floor.

>peck developer
You jab your beak at the purple-haired developer.

The developer shrieks in rage. She comes at you ready to kill.

You notice a little red box halfway up the wall. It's a fire alarm.

"Catch it," yells the enraged developer.

[Your score has just gone up by one point.]

* * *

>e
You waddle over with deadly purpose.

Office kitchen
This mini kitchen has tasty snacks and bad coffee. The main office is just to the west.

You can see a pod-based coffee maker, a sink, a cabinet (closed), and a purple-haired developer here.

>peck cup
You jab your beak at the cup of coffee.

Hot coffee spills all over the developer. She yells and drops the cup.

"Horrible goose," yells the enraged developer, chasing you.

>w
You waddle over with deadly purpose.

Open-plan office
A large room with narrow hallways running between grey-walled cubicles. Exits lead east, west, and south.

You can see a potted palm and a printer here.

"Catch it," yells the enraged developer. She trips over you, swearing.

The wet, scalded developer arrives from the east.

>s
You waddle over with deadly purpose.

Cubicle
An adjustable standing/sitting desk dominates this spacious cubicle. The main office is just to the north.

You can see an adjustable desk (on which are a tattered copy of Design Patterns and a laptop) here.

(You feel a mighty primal urge to honk, to flap, and to peck things.)

"Nnnnnnggggg," yells the enraged developer.

The wet, scalded developer arrives from the north.

>take book
You jab your beak at it.

"Catch it," yells the enraged developer.

[Your score has just gone up by one point.]

>n
You waddle over with deadly purpose.

Open-plan office
A large room with narrow hallways running between grey-walled cubicles. Exits lead east, west, and south.

You can see a potted palm and a printer here.

"Catch it," yells the enraged developer, chasing you.

The wet, scalded developer arrives from the south.

>e
You waddle over with deadly purpose.

Office kitchen
This mini kitchen has tasty snacks and bad coffee. The main office is just to the west.

You can see puddles of spilled coffee, an empty, cracked coffee cup, a pod-based coffee maker, and a sink here.

"Horrible goose," yells the enraged developer.

The wet, scalded developer arrives from the west.

>drop book
Dropped.

"Catch it," yells the enraged developer. She trips over you, swearing.

>l
Office kitchen
This mini kitchen has tasty snacks and bad coffee. The main office is just to the west.

You can see a wet book with the cover torn off, a wet, scalded developer, puddles of spilled coffee, an empty, cracked coffee cup, a pod-based coffee maker, and a sink here.

"Nnnnnnggggg," yells the enraged developer, chasing you.

>w
You waddle over with deadly purpose.

Open-plan office
A large room with narrow hallways running between grey-walled cubicles. Exits lead east, west, and south.

You can see a potted palm and a printer here.

"Catch it," yells the enraged developer. She trips over you, swearing.

The wet, scalded developer arrives from the east.

>take plant
You jab your beak at it.

"Catch it," yells the enraged developer. She trips over you, swearing.

[Your score has just gone up by one point.]

>e
You waddle over with deadly purpose.

Office kitchen
This mini kitchen has tasty snacks and bad coffee. The main office is just to the west.

You can see a wet book with the cover torn off, puddles of spilled coffee, an empty, cracked coffee cup, a pod-based coffee maker, and a sink here.

"Horrible goose," yells the enraged developer. She trips over you, swearing.

The wet, scalded developer arrives from the west.

>drop plant
Dropped.

"Catch it," yells the enraged developer.

>l
Office kitchen
This mini kitchen has tasty snacks and bad coffee. The main office is just to the west.

You can see a wet torn-up potted palm, lying sideways, a wet, scalded developer, a wet book with the cover torn off, puddles of spilled coffee, an empty, cracked coffee cup, a pod-based coffee maker, and a sink here.

"Horrible goose," yells the enraged developer.

I beg your pardon?

* * *

>e
You waddle over with deadly purpose.

Office kitchen
This mini kitchen has tasty snacks and bad coffee. The main office is just to the west.

You can see a pod-based coffee maker, a sink, a cabinet (closed), and a purple-haired developer here.

>peck developer
You jab your beak at the purple-haired developer.

The developer shrieks in rage. She comes at you ready to kill.

"Horrible goose," yells the developer, chasing you.

[Your score has just gone up by one point.]

>l
Office kitchen
This mini kitchen has tasty snacks and bad coffee.

You can see puddles of spilled coffee, an empty coffee cup, a pod-based coffee maker, a sink, and a purple-haired developer trying to catch you here.

>peck sink
You jab your beak at the sink.
The sink switches on.

The faucet cracks. Water sprays all over!

[Your score has just gone up by one point.]

>peck coffee
Which do you mean, puddles of spilled coffee, the empty coffee cup, or the pod-based coffee maker?

>peck coffee maker
You jab your beak at the pod-based coffee maker.
The pod-based coffee maker switches on.

Coffee sprays out of the coffee maker!

[Your score has just gone up by one point.]

>l
Office kitchen
This mini kitchen has tasty snacks and bad coffee.

You can see puddles of spilled coffee, puddles of water, an empty coffee cup, a pod-based coffee maker, a sink, and a purple-haired developer trying to catch you here.

>w
You waddle over with deadly purpose.

Open-plan office
A large room with narrow hallways running between grey-walled cubicles.

You can see a potted palm and a printer here.

>peck printer
You jab your beak at the printer.
The printer switches on.

Some sheets of paper fly out of the printer and across the room.

[Your score has just gone up by one point.]

>take palm
You jab your beak at it.

[Your score has just gone up by one point.]

>w
You waddle over with deadly purpose.

Conference room
A large board room with chairs arranged around a central table.

You can see a project manager, an ipad, and a video camera here.

>peck ipad
You jab your beak at the ipad.

A huge picture of a plump goose fills the conference room screen.
The conference call participants all start talking at once!
Someone yells, "STOP THAT GOOSE!" and starts to chase you!

[Your score has just gone up by one point.]

>drop palm
Dropped.

>peck manager
You jab your beak at the flustered geek, chasing you around the room..

You jab her in the butt, feeling a deep sense of satisfaction.
"OUCH!!! HEY!!!"
The project manager leaps up from her chair!

[Your score has just gone up by one point.]

* * *

>peck developer
You jab your beak at the purple-haired developer.

The developer shrieks in rage. She comes at you ready to kill.

"Horrible goose," yells the developer, chasing you.

[Your score has just gone up by one point.]

>peck sink
You jab your beak at the sink.
The sink switches on.

The faucet cracks. Water sprays all over!

"Catch it," yells the developer. She trips and falls over, swearing.

[Your score has just gone up by one point.]

>peck  coffee maker
You jab your beak at the pod-based coffee maker.
The pod-based coffee maker switches on.

Coffee sprays out of the coffee maker!

"Nnnnnnggggg," yells the developer.

[Your score has just gone up by one point.]

>w
You waddle over with deadly purpose.

Open-plan office
A large room with narrow hallways running between grey-walled cubicles. Exits lead east, west, and south.

You can see a potted palm and a printer here.

"Catch it," yells the developer.

The purple-haired developer trying to catch you arrives from the east.

>w
You waddle over with deadly purpose.

Conference room
A large board room with chairs arranged around a central table. Through the open door, you can see the main office.

You can see a project manager, an ipad, and a video camera here.

"Horrible goose," yells the developer, chasing you.

The purple-haired developer trying to catch you arrives from the east.

>peck ipad
You jab your beak at the ipad.

A huge picture of a plump goose fills the conference room screen.
The conference call participants all start talking at once!
Someone yells, "STOP THAT GOOSE!" and starts to chase you!

"Nnnnnnggggg," yells the developer.

[Your score has just gone up by one point.]

>peck manager
You jab your beak at the flustered geek, chasing you around the room.

You peck her in the butt, feeling a deep sense of satisfaction.
"OUCH!!! HEY!!!"
The project manager leaps up from her chair!

"Nnnnnnggggg," yells the developer. She trips and falls over, swearing.

[Your score has just gone up by one point.]

>peck camera
You leap several feet in the air but fail to peck the video camera.

"Catch it," yells the developer, chasing you.

>e
You waddle over with deadly purpose.

Open-plan office
A large room with narrow hallways running between grey-walled cubicles. Exits lead east, west, and south.

You can see a potted palm and a printer here.

"Nnnnnnggggg," yells the developer.

The purple-haired developer trying to catch you arrives from the west.

* * *

>peck sink
You jab your beak at the sink.
The sink switches on.

The faucet cracks. Water sprays all over!

"Catch it," yells the developer. She trips and falls over, swearing.

[Your score has just gone up by one point.]

>peck cup
You jab your beak at the empty coffee cup.

"Nnnnnnggggg," yells the developer.

>peck developer
You jab your beak at the purple-haired developer trying to catch you.

"Nnnnnnggggg," yells the developer, chasing you.

>peck coffeemaker
You can't see any such thing.

>peck coffee maker
You jab your beak at the pod-based coffee maker.
The pod-based coffee maker switches on.

Coffee sprays out of the coffee maker!

"Horrible goose," yells the developer. She trips and falls over, swearing.

[Your score has just gone up by one point.]

>w
You waddle over with deadly purpose.

Open-plan office
A large room with narrow hallways running between grey-walled cubicles. Exits lead east, west, and south.

You can see a potted palm and a printer here.

"Horrible goose," yells the developer.

The purple-haired developer trying to catch you arrives from the east.

>s
You waddle over with deadly purpose.

Cubicle
An adjustable standing/sitting desk dominates this spacious cubicle. The main office is just to the north.

You can see an adjustable desk (on which are a tattered copy of Design Patterns and a laptop) here.

"Catch it," yells the developer. She trips and falls over, swearing.

The purple-haired developer trying to catch you arrives from the north.

>n
You waddle over with deadly purpose.

Open-plan office
A large room with narrow hallways running between grey-walled cubicles. Exits lead east, west, and south.

You can see a potted palm and a printer here.

"Horrible goose," yells the developer.

The purple-haired developer trying to catch you arrives from the south.

>w
You waddle over with deadly purpose.

Conference room
A large board room with chairs arranged around a central table. Through the open door, you can see the main office.

You can see a project manager, an ipad, and a video camera here.

"Horrible goose," yells the developer, chasing you.

The purple-haired developer trying to catch you arrives from the east.

* * *

>peck developer
You jab your beak at the purple-haired developer.

The developer shrieks in rage. She comes at you ready to kill.

"Horrible goose," yells the developer, chasing you.

[Your score has just gone up by one point.]

>w
You waddle over with deadly purpose.

Open-plan office
A large room with narrow hallways running between grey-walled cubicles. Exits lead east, west, and south.

You can see a potted palm and a printer here.

"Catch it," yells the developer. She trips and falls over, swearing.

The purple-haired developer trying to catch you arrives from the east.

>w
You waddle over with deadly purpose.

Conference room
A large board room with chairs arranged around a central table. Through the open door, you can see the main office.

You can see a project manager, an ipad, and a video camera here.

"Nnnnnnggggg," yells the developer.

The purple-haired developer trying to catch you arrives from the east.

>peck manager
You jab your beak at the project manager.

You peck her in the butt, feeling a deep sense of satisfaction.
"OUCH!!! HEY!!!"
The project manager leaps up from her chair!

"Catch it," yells the developer. She trips and falls over, swearing.
"What the heck," shrieks the manager, lurching forward.

[Your score has just gone up by one point.]

>e
You waddle over with deadly purpose.

Open-plan office
A large room with narrow hallways running between grey-walled cubicles. Exits lead east, west, and south.

You can see a potted palm and a printer here.

"Horrible goose," yells the developer, chasing you.

The purple-haired developer trying to catch you arrives from the west.

"My meeting," shrieks the manager. She falls over a chair.

The flustered geek, chasing you around the room arrives from the west.

>s
You waddle over with deadly purpose.

Cubicle
An adjustable standing/sitting desk dominates this spacious cubicle. The main office is just to the north.

You can see an adjustable desk (on which are a tattered copy of Design Patterns and a laptop) here.

"Horrible goose," yells the developer.

The purple-haired developer trying to catch you arrives from the north.

* * *

>e
You waddle over with deadly purpose.

Office kitchen
This mini kitchen has tasty snacks and bad coffee. The main office is just to the west.

You can see a pod-based coffee maker, a sink, a cabinet (closed), and a purple-haired developer here.

>peck maker
You jab your beak at the pod-based coffee maker.
The pod-based coffee maker switches on.

Coffee sprays out of the coffee maker!

"Horrible goose," yells the enraged developer, chasing you.

[Your score has just gone up by one point.]

>peck cabinet
You jab your beak at the cabinet.

"Catch it," yells the enraged developer. She trips over you, swearing.

>open cabinet
It seems to be locked.

You feel a mighty primal urge to honk, to flap, and to peck things.

"Nnnnnnggggg," yells the enraged developer. She flails, knocking her own glasses onto the floor.

>peck developer
You jab your beak at the purple-haired developer.

The developer shrieks in rage. She comes at you ready to kill.

"Catch it," yells the enraged developer.

[Your score has just gone up by one point.]

>peck sink
You jab your beak at the sink.
The sink switches on.

The faucet cracks. Water sprays all over!

"Nnnnnnggggg," yells the enraged developer. She flails, knocking her own glasses onto the floor.

[Your score has just gone up by one point.]

>l
Office kitchen
This mini kitchen has tasty snacks and bad coffee. The main office is just to the west.

You can see a fire alarm, puddles of water, puddles of spilled coffee, an empty coffee cup, a mangled coffee maker, a sink with a broken faucet spraying water everywhere, a cabinet (closed), and a wet, scalded developer here.

"Horrible goose," yells the enraged developer, chasing you.

>peck alarm
You jab your beak at the fire alarm.
The fire alarm switches on.

The glass covering the fire alarm switch breaks.
ooooooOOOOOOooooooo!
The developer panics, opens a cupboard and takes out a fire extinguisher.

oooooOOOOOOoooooo BEEP BEEP BEEP!

"Catch it," yells the enraged developer, chasing you.

[Your score has just gone up by one point.]

>l
Office kitchen
This mini kitchen has tasty snacks and bad coffee. The main office is just to the west.

You can see a fire alarm, puddles of water, puddles of spilled coffee, an empty coffee cup, a mangled coffee maker, a sink with a broken faucet spraying water everywhere, a cabinet (in which is Tasty snacks), and a wet, scalded developer here.

"Catch it," yells the enraged developer. She trips over you, swearing.

* * *

>peck maker
You jab your beak at the pod-based coffee maker.
The pod-based coffee maker switches on.

Coffee sprays out of the coffee maker!

"Horrible goose," yells the enraged developer, chasing you.

[Your score has just gone up by one point.]

>peck sink
You jab your beak at the sink.
The sink switches on.

The faucet cracks. Water sprays all over!

"Catch it," yells the enraged developer. She trips over you, swearing.

[Your score has just gone up by one point.]

>peck developer
You jab your beak at the purple-haired developer.

The developer shrieks in rage. She comes at you ready to kill.

You feel a mighty primal urge to honk, to flap, and to peck things.

"Nnnnnnggggg," yells the enraged developer. She flails, knocking her own glasses onto the floor.

[Your score has just gone up by one point.]

>l
Office kitchen
This mini kitchen has tasty snacks and bad coffee. The main office is just to the west.

You can see a fire alarm, puddles of spilled coffee, an empty coffee cup, puddles of water, a mangled coffee maker, a sink with a broken faucet spraying water everywhere, and a wet, scalded developer here.

Hey, what's that little red box on the wall?

"Catch it," yells the enraged developer.

* * *

>peck developer
You jab your beak at the purple-haired developer.

The developer shrieks in rage. She comes at you ready to kill.

You feel a mighty primal urge to honk, to flap, and to peck things.

"Nnnnnnggggg," yells the enraged developer. She flails, knocking her own glasses onto the floor.

[Your score has just gone up by one point.]

>peck alarm
You jab your beak at the fire alarm.
The fire alarm switches on.

The glass covering the fire alarm switch breaks.
ooooooOOOOOOooooooo!
The developer panics, opens a cupboard and takes out a fire extinguisher.

"Horrible goose," yells the enraged developer.

[Your score has just gone up by one point.]

>l
Office kitchen
This mini kitchen has tasty snacks and bad coffee. The main office is just to the west.

You can see a fire alarm, puddles of spilled coffee, an empty coffee cup, puddles of water, a mangled coffee maker, a sink with a broken faucet spraying water everywhere, an open cabinet (in which are some tasty snacks), and a wet, scalded developer here.

oooooOOOOOOoooooo BEEP BEEP BEEP!

"Horrible goose," yells the enraged developer.

>take snacks
You stretch out your neck, biting and gnashing.

You grab the tasty snacks with your powerful beak.

Taken.

"Horrible goose," yells the enraged developer. She flails, knocking her own glasses onto the floor.

>i
You are carrying: 
  some tasty snacks (in your beak)

oooooOOOOOOoooooo BEEP BEEP BEEP!

"Nnnnnnggggg," yells the enraged developer, chasing you.

>peck developer
You drop the tasty snacks and jab viciously.

She slips and falls, dropping the extinguisher.

"Horrible goose," yells the enraged developer. She flails, knocking her own glasses onto the floor.

>peck extinguisher
You jab your beak at the fire extinguisher.
The fire extinguisher switches on.

Nasty-smelling foam spews out of the extinguisher, coating the walls.

oooooOOOOOOoooooo BEEP BEEP BEEP!

"Nnnnnnggggg," yells the enraged developer, chasing you.

[Your score has just gone up by one point.]

>eat snacks
(first taking the tasty snacks)
You stretch out your neck, biting and gnashing.

You grab the tasty snacks with your powerful beak.

You eat the tasty snacks. Not bad.

"Nnnnnnggggg," yells the enraged developer. She flails, knocking her own glasses onto the floor.

* * *

>peck developer
You jab your beak at the purple-haired developer.

The developer shrieks in rage. She comes at you ready to kill.

You feel a mighty primal urge to honk, to flap, and to peck things.

"Nnnnnnggggg," yells the enraged developer. She flails, knocking her own glasses onto the floor.

[Your score has just gone up by one point.]

>peck maker
You jab your beak at the mangled coffee maker.
The mangled coffee maker seems to be broken now.

You suddenly notice a bright red fire alarm high up on the wall.

"Catch it," yells the enraged developer.

>l
Office kitchen
This mini kitchen has tasty snacks and bad coffee. The main office is just to the west.

You can see a fire alarm, puddles of spilled coffee, an empty coffee cup, puddles of water, a mangled coffee maker, a sink with a broken faucet spraying water everywhere, a cabinet (closed), and a wet, scalded developer here.

You suddenly notice a bright red fire alarm high up on the wall.

"Horrible goose," yells the enraged developer. She flails, knocking her own glasses onto the floor.

* * *

>e
You waddle over with deadly purpose.

Office kitchen
This mini kitchen has tasty snacks and bad coffee. The main office is just to the west.

You can see a pod-based coffee maker, a sink, a cabinet (closed), and a purple-haired developer here.

>peck sink
You jab your beak at the sink.
The sink switches on.

The faucet cracks. Water sprays all over!

"Horrible goose," yells the enraged developer, chasing you.

[Your score has just gone up by one point.]

>drink water
You drink from the puddles of water.

"Catch it," yells the developer. She trips and falls over, swearing.

>peck coffee maker
You jab your beak at the pod-based coffee maker.
The pod-based coffee maker switches on.

Coffee sprays out of the coffee maker!

(You feel a mighty primal urge to honk, to flap, and to peck things.)

"Nnnnnnggggg," yells the developer.

[Your score has just gone up by one point.]

* * *

>peck sink
You jab your beak at the sink.
The sink switches on.

The faucet cracks. Water sprays all over!

"Horrible goose," yells the enraged developer, chasing you.

[Your score has just gone up by one point.]

>l
Office kitchen
This mini kitchen has tasty snacks and bad coffee. The main office is just to the east.

You can see puddles of water, a pod-based coffee maker, a sink, and a purple-haired developer here.

"Catch it," yells the developer. She trips and falls over, swearing.

>drink water
You drink some puddles of water.

(You feel a mighty primal urge to honk, to flap, and to peck things.)

"Nnnnnnggggg," yells the developer.

* * *

>peck sink
You jab your beak at the sink.
The sink switches on.

The faucet cracks. Water sprays all over!

"Horrible goose," yells the enraged developer, chasing you.

[Your score has just gone up by one point.]

>peck coffee maker
You jab your beak at the pod-based coffee maker.
The pod-based coffee maker switches on.

Coffee sprays out of the coffee maker!

"Catch it," yells the enraged developer. She trips over you, swearing.

[Your score has just gone up by one point.]

>peck developer
You jab your beak at the purple-haired developer.

The developer shrieks in rage. She comes at you ready to kill.

You feel a mighty primal urge to honk, to flap, and to peck things.

"Nnnnnnggggg," yells the enraged developer. She flails, knocking her own glasses onto the floor.

[Your score has just gone up by one point.]

>l
Office kitchen
This mini kitchen has tasty snacks and bad coffee. The main office is just to the west.

You can see a fire alarm, puddles of spilled coffee, an empty coffee cup, puddles of water, a mangled coffee maker, a sink with a broken faucet spraying water everywhere, a cabinet (closed), and a wet, scalded developer here.

"Catch it," yells the enraged developer.

>peck alarm
You jab your beak at the fire alarm.
The fire alarm switches on.

The glass covering the fire alarm switch breaks.
ooooooOOOOOOooooooo!
The developer panics, opens a cupboard and takes out a fire extinguisher.

oooooOOOOOOoooooo BEEP BEEP BEEP!

"Nnnnnnggggg," yells the enraged developer. She trips over you, swearing.

[Your score has just gone up by one point.]

>l
Office kitchen
This mini kitchen has tasty snacks and bad coffee. The main office is just to the west.

You can see a fire alarm, puddles of spilled coffee, an empty coffee cup, puddles of water, a mangled coffee maker, a sink with a broken faucet spraying water everywhere, an open cabinet (in which are some tasty snacks), and a wet, scalded developer here.

"Nnnnnnggggg," yells the enraged developer, chasing you.

>take snacks
You stretch out your neck, biting and gnashing.

You grab the tasty snacks with your powerful beak.

Taken.

oooooOOOOOOoooooo BEEP BEEP BEEP!

"Nnnnnnggggg," yells the enraged developer, chasing you.

>i
You are carrying: 
  some tasty snacks (in your beak)

"Horrible goose," yells the enraged developer. She trips over you, swearing.

>eat snacks
You eat the tasty snacks. Not bad.

oooooOOOOOOoooooo BEEP BEEP BEEP!

"Horrible goose," yells the enraged developer.

* * *

>peck sink
You jab your beak at the sink.
The sink switches on.

The faucet cracks. Water sprays all over!

"Horrible goose," yells the enraged developer, chasing you.

[Your score has just gone up by one point.]

>peck developer
You jab your beak at the purple-haired developer.

The developer shrieks in rage. She comes at you ready to kill.

"Catch it," yells the developer, chasing you.

[Your score has just gone up by one point.]

* * *

>e
You waddle over with deadly purpose.

Office kitchen
This mini kitchen has tasty snacks and bad coffee. The main office is just to the west.

You can see a pod-based coffee maker, a sink, a cabinet (closed), and a purple-haired developer here.

>take snacks
You can't see any such thing.

>look snacks
They're just out of your reach. Infuriating.

* * *

>take snacks
You can't see any such thing.

>open cabinet
It seems to be locked.

>unlock cabinet
What do you want to unlock the cabinet with?

>peck developer
You jab your beak at the purple-haired developer.

The developer shrieks in rage. She comes at you ready to kill.

"Horrible goose," yells the enraged developer, chasing you.

[Your score has just gone up by one point.]

>peck sink
You jab your beak at the sink.
The sink switches on.

The faucet cracks. Water sprays all over!

You feel a mighty primal urge to honk, to flap, and to peck things.

"Catch it," yells the enraged developer. She trips over you, swearing.

[Your score has just gone up by one point.]

>l
Office kitchen
This mini kitchen has tasty snacks and bad coffee. The main office is just to the west.

You can see puddles of water, puddles of spilled coffee, an empty coffee cup, a pod-based coffee maker, a sink with a broken faucet spraying water everywhere, a cabinet (closed), and a wet, scalded developer here.

"Nnnnnnggggg," yells the enraged developer. She flails, knocking her own glasses onto the floor.

>peck coffee maker
You jab your beak at the pod-based coffee maker.
The pod-based coffee maker switches on.

Coffee sprays out of the coffee maker!

"Catch it," yells the enraged developer.

[Your score has just gone up by one point.]

>l
Office kitchen
This mini kitchen has tasty snacks and bad coffee. The main office is just to the west.

You can see a fire alarm, puddles of spilled coffee, puddles of water, an empty coffee cup, a mangled coffee maker, a sink with a broken faucet spraying water everywhere, a cabinet (closed), and a wet, scalded developer here.

"Nnnnnnggggg," yells the enraged developer. She flails, knocking her own glasses onto the floor.

* * *

>e
You waddle over with deadly purpose.

Office kitchen
This mini kitchen has tasty snacks and bad coffee. The main office is just to the west.

You can see a pod-based coffee maker, a sink, a cabinet (closed), and a purple-haired developer here.

>x cabinet
You see nothing special about the cabinet.

>take snacks
You can't see any such thing.

* * *

>e
You waddle over with deadly purpose.

Office kitchen
This mini kitchen has tasty snacks and bad coffee. The main office is just to the west.

You can see a pod-based coffee maker, a sink, a cabinet (closed), and a purple-haired developer here.

>x developer
The purple-haired developer is carrying a cup of coffee.

>peck cup
You jab your beak at the cup of coffee.

Hot coffee spills all over the developer. She yells and drops the cup.

>x developer
The purple-haired developer is carrying nothing.

* * *

Office Goose
An Interactive Fiction by Lizzard
Release 11 / Serial number 191231 / Inform 7 build 6M62 (I6/v6.33 lib 6/12N) SD
It's a beautiful day in the office, and you are a horrible goose.
(If you aren't sure how to play, type "help" and hit enter.)

Open-plan office
You're in a large open room. Narrow corridors run between grey-walled cubicles. Exits lead east, west, and south.

You can see a potted palm and a printer here.

>flap
You flap your wings, menacing everything in the near vicinity.

>w
You waddle over with deadly purpose.

Conference room
A large board room with chairs arranged around a central table.

You can see a project manager, an ipad, and a video camera here.

>flap
You flap your wings, menacing everything in the near vicinity.

Everyone in the room starts in surprise.

>honk
HONK!!!!

Startled, a hapless office worker looks up in alarm.

>l
Conference room
A large board room with chairs arranged around a central table.

You can see a project manager, an ipad, and a video camera here.

>e
You waddle over with deadly purpose.

Open-plan office
A large room with narrow hallways running between grey-walled cubicles.

You can see a potted palm and a printer here.

>e
You waddle over with deadly purpose.

Office kitchen
This mini kitchen has tasty snacks and bad coffee.

You can see a pod-based coffee maker, a sink, and a purple-haired developer here.

>peck cup
You jab your beak at the cup of coffee.

>l
Office kitchen
This mini kitchen has tasty snacks and bad coffee.

You can see a pod-based coffee maker, a sink, and a purple-haired developer here.

* * *

Office Goose
An Interactive Fiction by Lizzard
Release 11 / Serial number 191231 / Inform 7 build 6M62 (I6/v6.33 lib 6/12N) SD
It's a beautiful day in the office, and you are a horrible goose.
(If you aren't sure how to play, type "help" and hit enter.)

Open-plan office
You're in a large open room. Narrow corridors run between grey-walled cubicles. Exits lead east, west, and south.

You can see a potted palm and a printer here.

>help
You can honk and flap. Also, you can peck things.
"look" shows you what's in a room
"x" or examine shows you a long description of an object
"i" shows what you are carrying
"take" may work on objects light enough for you to pick up
After you mess with a thing, try examining it again!
n, e, s, w to go north, east, south, west.
It may help to jot down what rooms are where, in a small map.

>bite palm
You jab your beak at the potted palm.

Dirt spills out. How satisfying. You could probably pick up the whole plant.

* * *

>help
You can honk and flap. Also, you can peck things.
"look" shows you what's in a room
"x" or examine shows you a long description of an object
"i" shows what you are carrying
"take" may work on objects light enough for you to pick up
After you mess with a thing, try examining it again!
n, e, s, w to go north, east, south, west.
It may help to jot down what rooms are where, in a small map.

>e
You waddle over with deadly purpose.

Office kitchen
This mini kitchen has tasty snacks and bad coffee. The main office is just to the west.

You can see a pod-based coffee maker, a sink, a cabinet (closed), and a purple-haired developer here.

* * *

>peck maker
You jab your beak at the pod-based coffee maker.
The pod-based coffee maker switches on.

Coffee sprays out of the coffee maker!

"Horrible goose," yells the enraged developer, chasing you.

[Your score has just gone up by one point.]

>peck developer
You jab your beak at the purple-haired developer.

The developer shrieks in rage. She comes at you ready to kill.

You feel a mighty primal urge to honk, to flap, and to peck things.

"Catch it," yells the enraged developer. She trips over you, swearing.

[Your score has just gone up by one point.]

>peck sink
You jab your beak at the sink.
The sink switches on.

The faucet cracks. Water sprays all over!

"Nnnnnnggggg," yells the enraged developer. She flails, knocking her own glasses onto the floor.

[Your score has just gone up by one point.]

>l
Office kitchen
This mini kitchen has tasty snacks and bad coffee. The main office is just to the west.

You can see a fire alarm, puddles of water, puddles of spilled coffee, an empty coffee cup, a mangled coffee maker, a sink with a broken faucet spraying water everywhere, a cabinet (closed), and a wet, scalded developer here.

"Horrible goose," yells the enraged developer.

>peck fire alarm
You jab your beak at the fire alarm.
The fire alarm switches on.

The glass covering the fire alarm switch breaks.
ooooooOOOOOOooooooo!
The developer panics, opens a cupboard and takes out a fire extinguisher.

"Nnnnnnggggg," yells the enraged developer.

[Your score has just gone up by one point.]

>peck developer
You jab your beak at the wet, scalded developer.

oooooOOOOOOoooooo BEEP BEEP BEEP!

"Nnnnnnggggg," yells the enraged developer. She flails, knocking her own glasses onto the floor.

>l
Office kitchen
This mini kitchen has tasty snacks and bad coffee. The main office is just to the west.

You can see a fire alarm, puddles of water, puddles of spilled coffee, an empty coffee cup, a mangled coffee maker, a sink with a broken faucet spraying water everywhere, an open cabinet (in which are some tasty snacks), and a wet, scalded developer here.

"Catch it," yells the enraged developer. She trips over you, swearing.

>x developer
The wet, scalded developer is carrying a fire extinguisher.

oooooOOOOOOoooooo BEEP BEEP BEEP!

"Nnnnnnggggg," yells the enraged developer. She trips over you, swearing.

>peck extinguisher
You jab your beak at the fire extinguisher.
The fire extinguisher switches on.

Nasty-smelling foam spews out of the extinguisher, coating the walls.

"Nnnnnnggggg," yells the enraged developer.

[Your score has just gone up by one point.]

* * *

Office Goose
An Interactive Fiction by Lizzard
Release 11 / Serial number 191231 / Inform 7 build 6M62 (I6/v6.33 lib 6/12N) SD
It's a beautiful day in the office, and you are a horrible goose.
(If you aren't sure how to play, type "help" and hit enter.)

Open-plan office
You're in a large open room. Narrow corridors run between grey-walled cubicles. Exits lead east, west, and south.

You can see a potted palm and a printer here.

>honk
HONK!!!!

>e
You waddle over with deadly purpose.

Office kitchen
This mini kitchen has tasty snacks and bad coffee.

You can see a pod-based coffee maker, a sink, and a purple-haired developer here.

>honk
HONK!!!!

Startled, the person looks up in alarm.

* * *

>honk
HONK!!!!

>flap
You flap your wings, menacing everything in the near vicinity.

>look self
You're large, you're white, and you're waddling.

>l
Open-plan office
A large room with narrow hallways running between grey-walled cubicles.

You can see a potted palm and a printer here.

>e
You waddle over with deadly purpose.

Office kitchen
This mini kitchen has tasty snacks and bad coffee.

You can see a pod based coffee maker, a sink and a purple-haired developer here.

* * *

>honk
HONK!!!!

>look printer
This large printer has a ton of options for copying, collating, and stapling.
 What would happen if you pecked it, hard, with your powerful beak?

The printer is currently switched off.

>peck printer
You jab your beak at the printer.
The printer switches on.

Some sheets of paper fly out of the printer and across the room.

[Your score has just gone up by one point.]

>look paper
You see nothing special about the sheets of paper.

(You feel a mighty primal urge to honk, to flap, and to peck things.)

>look plant
A large indoor plant with luxuriant fronds.
You feel an urge to peck it.

>peck fronds
You jab your beak at the potted palm.

Dirt spills out. How satisfying. You could probably pick up the whole plant.

>get plant
You jab your beak at it.

[Your score has just gone up by one point.]

>flap
You flap your wings, menacing everything in the near vicinity.

>look
Open-plan office
A large room with narrow hallways running between grey-walled cubicles. Exits lead east, west, and south.

You can see some spilled dirt, some sheets of paper, and a dented printer here.

>peck printer
You jab your beak at the dented printer.
The dented printer switches off.

>peck printer
You jab your beak at the dented printer.
The dented printer switches on.

>i
You are carrying: 
  a torn-up potted palm, lying sideways (in your beak)

>honk
HONK!!!!

>look
Open-plan office
A large room with narrow hallways running between grey-walled cubicles. Exits lead east, west, and south.

You can see some spilled dirt, some sheets of paper, and a dented printer here.

>go cubicle
You can't see any such thing.

>go east
You waddle over with deadly purpose.

Office kitchen
This mini kitchen has tasty snacks and bad coffee. The main office is just to the east.

You can see a pod-based coffee maker, a sink, and a purple-haired developer here.

>go east
You waddle over with deadly purpose.

You can't go that way.

>throw plant at developer
You lack the nerve when it comes to the crucial moment.

>honk
HONK!!!!

Startled, a hapless office worker looks up in alarm.

>honk honk
I only understood you as far as wanting to honk.

>peck coffee maker
You jab your beak at the pod-based coffee maker.
The pod-based coffee maker switches on.

Coffee sprays out of the coffee maker!

"Horrible goose," yells the enraged developer, chasing you.

[Your score has just gone up by one point.]

>i
You are carrying: 
  a torn-up potted palm, lying sideways (in your beak)

"Catch it," yells the enraged developer. She trips over you, swearing.

>drop plant
Dropped.

"Nnnnnnggggg," yells the enraged developer.

>i
You are carrying nothing.

"Horrible goose," yells the enraged developer, chasing you.

>peck developer
You jab your beak at the purple-haired developer.

The developer shrieks in rage. She comes at you ready to kill.

"Nnnnnnggggg," yells the enraged developer. She trips over you, swearing.

[Your score has just gone up by one point.]

>flap menacingly
I only understood you as far as wanting to flap.

>flap
You flap your wings, menacing everything in the near vicinity.

Everyone in the room starts in surprise.

"Nnnnnnggggg," yells the enraged developer.

>look
Office kitchen
This mini kitchen has tasty snacks and bad coffee. The main office is just to the east.

You can see puddles of spilled coffee, an empty coffee cup, a torn-up potted palm, lying sideways, a mangled coffee maker, a sink, and a wet, scalded developer here.

"Horrible goose," yells the enraged developer. She trips over you, swearing.

>go west
You waddle over with deadly purpose.

Open-plan office
A large room with narrow hallways running between grey-walled cubicles. Exits lead east, west, and south.

You can see some spilled dirt, some sheets of paper, and a dented printer here.

"Catch it," yells the enraged developer. She trips over you, swearing.

The wet, scalded developer arrives from the east.

>west
You waddle over with deadly purpose.

Conference room
A large board room with chairs arranged around a central table. Through the open door, you can see the main office to the east.

You can see a project manager, an ipad, and a video camera here.

"Catch it," yells the enraged developer, chasing you.

The wet, scalded developer arrives from the east.

>honk
HONK!!!!

Startled, a hapless office worker looks up in alarm.

"Nnnnnnggggg," yells the enraged developer, chasing you.

>peck video camersa
I only understood you as far as wanting to peck the video camera.

>peck video camera
You leap several feet in the air but fail to peck the video camera.

"Nnnnnnggggg," yells the enraged developer. She trips over you, swearing.

>jump chair
I only understood you as far as wanting to jump.

>jump
You jump on the spot.

"Horrible goose," yells the enraged developer, chasing you.

>jump table
I only understood you as far as wanting to jump.

>l
Conference room
A large board room with chairs arranged around a central table. Through the open door, you can see the main office to the east.

You can see a wet, scalded developer, a project manager, an ipad, and a video camera here.

"Catch it," yells the enraged developer, chasing you.

>peck ipad
You jab your beak at the ipad.

A huge picture of a plump goose fills the conference room screen.
The conference call participants all start talking at once!
Someone yells, "STOP THAT GOOSE!" and starts to chase you!

"Horrible goose," yells the enraged developer.

[Your score has just gone up by one point.]

>l
Conference room
A large board room with chairs arranged around a central table. Through the open door, you can see the main office to the east.

You can see a wet, scalded developer, a flustered manager, a battered and scratched ipad, and a video camera here.

"Catch it," yells the enraged developer, chasing you.

>e
You waddle over with deadly purpose.

Open-plan office
A large room with narrow hallways running between grey-walled cubicles. Exits lead east, west, and south.

You can see some spilled dirt, some sheets of paper, and a dented printer here.

"Horrible goose," yells the enraged developer. She trips over you, swearing.

The wet, scalded developer arrives from the west.

>s
You waddle over with deadly purpose.

Cubicle
An adjustable standing/sitting desk dominates this spacious cubicle. The main office is just to the north.

You can see an adjustable desk (on which are a tattered copy of Design Patterns and a laptop) here.

"Catch it," yells the enraged developer.

The wet, scalded developer arrives from the north.

>peck laptop
You jab your beak at the laptop.

Your beak mashes the keys and cracks the screen.

"Catch it," yells the enraged developer. She trips over you, swearing.

[Your score has just gone up by one point.]

>honk
HONK!!!!

Startled, a hapless office worker looks up in alarm.

"Catch it," yells the enraged developer.

>peck desk
You jab your beak at the adjustable desk.

The desk starts going up and down at random.

"Nnnnnnggggg," yells the enraged developer, chasing you.

[Your score has just gone up by one point.]

>peck magazine
You can't see any such thing.

>look
Cubicle
An adjustable standing/sitting desk dominates this spacious cubicle. The main office is just to the north.

You can see a wet, scalded developer and a broken adjustable desk (on which are a tattered copy of Design Patterns and a broken laptop) here.

"Catch it," yells the enraged developer. She trips over you, swearing.

>peck book
You jab your beak at the tattered copy of Design Patterns.

Tasty! You could pick up the whole book and carry it around!

"Nnnnnnggggg," yells the enraged developer, chasing you.

>i
You are carrying nothing.

"Catch it," yells the enraged developer, chasing you.

>get book
You jab your beak at it.

"Catch it," yells the enraged developer, chasing you.

[Your score has just gone up by one point.]

>l
Cubicle
An adjustable standing/sitting desk dominates this spacious cubicle. The main office is just to the north.

You can see some little bits of chewed up paper, a wet, scalded developer, and a broken adjustable desk (on which is a broken laptop) here.

"Nnnnnnggggg," yells the enraged developer. She trips over you, swearing.

>n
You waddle over with deadly purpose.

Open-plan office
A large room with narrow hallways running between grey-walled cubicles. Exits lead east, west, and south.

You can see some spilled dirt, some sheets of paper, and a dented printer here.

"Horrible goose," yells the enraged developer, chasing you.

The wet, scalded developer arrives from the south.

>e
You waddle over with deadly purpose.

Office kitchen
This mini kitchen has tasty snacks and bad coffee. The main office is just to the east.

You can see puddles of spilled coffee, an empty coffee cup, a torn-up potted palm, lying sideways, a mangled coffee maker, and a sink here.

"Nnnnnnggggg," yells the enraged developer. She trips over you, swearing.

The wet, scalded developer arrives from the west.

>put book in puddle
You can't see any such thing.

>look
Office kitchen
This mini kitchen has tasty snacks and bad coffee. The main office is just to the east.

You can see a wet, scalded developer, puddles of spilled coffee, an empty coffee cup, a torn-up potted palm, lying sideways, a mangled coffee maker, and a sink here.

"Catch it," yells the enraged developer, chasing you.

>peck cup
You jab your beak at the empty coffee cup.

"Catch it," yells the enraged developer. She trips over you, swearing.

>l
Office kitchen
This mini kitchen has tasty snacks and bad coffee. The main office is just to the east.

You can see a wet, scalded developer, puddles of spilled coffee, an empty coffee cup, a torn-up potted palm, lying sideways, a mangled coffee maker, and a sink here.

"Horrible goose," yells the enraged developer.

* * *

>honk
HONK!!!!

>w
You waddle over with deadly purpose.

Conference room
A large board room with chairs arranged around a central table. Through the open door, you can see the main office to the east.

You can see a project manager, an ipad, and a video camera here.

>honk
HONK!!!!

Startled, a hapless office worker looks up in alarm.

>honk
HONK!!!!

A person near you jumps in fear.

You feel a mighty primal urge to honk, to flap, and to peck things.

>honk
HONK!!!!

Someone does a double take as they realize how close you are.

>flap
You flap your wings, menacing everything in the near vicinity.

Everyone in the room starts in surprise.

>flap
You flap your wings, menacing everything in the near vicinity.

One of your powerful wings clubs someone in the elbow.

* * *

Office Goose
An Interactive Fiction by Lizzard
Release 11 / Serial number 191231 / Inform 7 build 6M62 (I6/v6.33 lib 6/12N) SD
It's a beautiful day in the office, and you are a horrible goose.
(If you aren't sure how to play, type "help" and hit enter.)

Open-plan office
You're in a large open room. Narrow corridors run between grey-walled cubicles. Exits lead east, west, and south.

You can see a potted palm and a printer here.

>i
You are carrying nothing.

>take plam
You can't see any such thing.

>take palm
You jab your beak at it.

Taken.

>i
You are carrying: 
  a potted palm (in your beak)

* * *

Office Goose
An Interactive Fiction by Lizzard
Release 11 / Serial number 191231 / Inform 7 build 6M62 (I6/v6.33 lib 6/12N) SD
It's a beautiful day in the office, and you are a horrible goose.
(If you aren't sure how to play, type "help" and hit enter.)

Open-plan office
You're in a large open room. Narrow corridors run between grey-walled cubicles. Exits lead east, west, and south.

You can see a potted palm and a printer here.

>l
Open-plan office
A large room with narrow hallways running between grey-walled cubicles. Exits lead east, west, and south.

You can see a potted palm and a printer here.

>e
You waddle over with deadly purpose.

Office kitchen
This mini kitchen has tasty snacks and bad coffee. The main office is just to the east.

You can see a pod-based coffee maker, a sink, and a purple-haired developer here.

>peck developer
You jab your beak at the purple-haired developer.

The developer shrieks in rage. She comes at you ready to kill.

[Your score has just gone up by one point.]

>l
Office kitchen
This mini kitchen has tasty snacks and bad coffee.

You can see Puddles of spilled coffee, an empty coffee cup, a pod-based coffee maker, a sink, and a purple-haired developer trying to catch you here.

* * *

>e
You waddle over with deadly purpose.

Office kitchen
This mini kitchen has tasty snacks and bad coffee. The main office is just to the east.

You can see a pod-based coffee maker, a sink, and a purple-haired developer here.

>take snacks
You can't see any such thing.

* * *

>l
Open-plan office
A large room with narrow hallways running between grey-walled cubicles. Exits lead east, west, and south.

You can see a potted palm and a printer here.

>i
You are carrying nothing.

>l
Open-plan office
A large room with narrow hallways running between grey-walled cubicles. Exits lead east, west, and south.

You can see a potted palm and a printer here.

>l
Open-plan office
A large room with narrow hallways running between grey-walled cubicles. Exits lead east, west, and south.

You can see a potted palm and a printer here.

(You feel a mighty primal urge to honk, to flap, and to peck things.)

>honk
HONK!!!!

>help
You can honk and flap. Also, you can peck things.
"look" shows you what's in a room. "x" for examine shows you a long description of an object.
"take" may work on objects light enough for you to pick up.

* * *

Office Goose
An Interactive Fiction by Lizzard
Release 11 / Serial number 191231 / Inform 7 build 6M62 (I6/v6.33 lib 6/12N) SD
It's a beautiful day in the office, and you are a horrible goose.
(If you aren't sure how to play, type "help" and hit enter.)

Open-plan office
You're in a large open room. Narrow corridors run between grey-walled cubicles. Exits lead east, west, and south.

You can see a potted palm and a printer here.

>look palm
A large indoor plant with luxuriant fronds.
You feel an urge to peck it.

>l
Open-plan office
A large room with narrow hallways running between grey-walled cubicles. Exits lead east, west, and south.

You can see a potted palm and a printer here.

>x printer
This large printer has a ton of options for copying, collating, and stapling.
 What would happen if you pecked it, hard, with your powerful beak?

The printer is currently switched off.

>switch on printer
A concept somewhat beyond you. Try pecking it instead.

(You feel a mighty primal urge to honk, to flap, and to peck things.)

>peck printer
You jab your beak at the printer.
The printer switches on.

Some sheets of paper fly out of the printer and across the room.

[Your score has just gone up by one point.]

>l
Open-plan office
A large room with narrow hallways running between grey-walled cubicles. Exits lead east, west, and south.

You can see some sheets of paper, a potted palm, and a dented printer here.

* * *

>look palm
A large indoor plant with luxuriant fronds.
You feel an urge to peck it.

>look fronds
You can't see any such thing.

* * *

>look palm
A large indoor plant with luxuriant fronds.
You feel an urge to peck it.

>look printer
The printer is currently switched off.

* * *

Office Goose
An Interactive Fiction by Lizzard
Release 11 / Serial number 191231 / Inform 7 build 6M62 (I6/v6.33 lib 6/12N) SD
It's a beautiful day in the office, and you are a horrible goose.
(If you aren't sure how to play, type "help" and hit enter.)

Open-plan office
You're in a large open room. Narrow corridors run between grey-walled cubicles. Exits lead east, west, and south.

You can see a potted palm and a printer here.

>n
You waddle over with deadly purpose.

You can't go that way.

>e
You waddle over with deadly purpose.

Office kitchen
This mini kitchen has tasty snacks and bad coffee. The main office is just to the east.

You can see a pod-based coffee maker, a sink, and a purple-haired developer here.

>l snack
You can't see any such thing.

>look snacks
You see nothing special about the snacks.

* * *

Office Goose
An Interactive Fiction by Lizzard
Release 11 / Serial number 191231 / Inform 7 build 6M62 (I6/v6.33 lib 6/12N) SD
It's a beautiful day in the office, and you are a horrible goose.
(If you aren't sure how to play, type "help" and hit enter.)

Open-plan office
You're in a large open room. Narrow corridors run between grey-walled cubicles. Exits lead east, west, and south.

You can see a potted palm and a printer here.

>peck palm
You jab your beak at the potted palm.

Dirt spills out. How satisfying. You could probably pick up the whole plant.

>e
You waddle over with deadly purpose.

Office kitchen
This mini kitchen has tasty snacks and bad coffee. The main office is just to the east.

You can see a pod-based coffee maker, a sink, and a purple-haired developer here.

* * *

>peck developer
You jab your beak at the purple-haired developer.

The developer shrieks in rage. She comes at you ready to kill.

[Your score has just gone up by one point.]

>l
Office kitchen
This mini kitchen has tasty snacks and bad coffee. The main office is just to the east.

You can see puddles of spilled coffee, an empty coffee cup, a pod-based coffee maker, a sink, and a purple-haired developer trying to catch you here.

>w
You waddle over with deadly purpose.

Open-plan office
A large room with narrow hallways running between grey-walled cubicles. Exits lead east, west, and south.

You can see some spilled dirt, a torn-up potted palm, lying sideways, and a printer here.

The purple-haired developer trying to catch you arrives from the east.

"Horrible goose!" yells the developer, chasing you.

>w
You waddle over with deadly purpose.

Conference room
A large board room with chairs arranged around a central table. Through the open door, you can see the main office.

You can see a project manager, an ipad, and a video camera here.

The purple-haired developer trying to catch you arrives from the east.

"Horrible goose!" yells the developer, chasing you.

>e
You waddle over with deadly purpose.

Open-plan office
A large room with narrow hallways running between grey-walled cubicles. Exits lead east, west, and south.

You can see some spilled dirt, a torn-up potted palm, lying sideways, and a printer here.

The purple-haired developer trying to catch you arrives from the west.

"Horrible goose!" yells the developer, chasing you.

* * *

>e
You waddle over with deadly purpose.

Office kitchen
This mini kitchen has tasty snacks and bad coffee. The main office is just to the east.

You can see a pod-based coffee maker, a sink, and a purple-haired developer here.

>peck sink
You jab your beak at the sink.
The sink switches on.

The faucet cracks. Water sprays all over!

"Catch it!"
 yells the developer, chasing you.

[Your score has just gone up by one point.]

>peck developer
You jab your beak at the purple-haired developer.

The developer shrieks in rage. She comes at you ready to kill.

"Catch it!"
 yells the developer. She trips and falls over, swearing.

[Your score has just gone up by one point.]

>peck developer
You jab your beak at the purple-haired developer trying to catch you.

"Horrible goose!"
 yells the developer, chasing you.

* * *

>peck palm
You jab your beak at the potted palm.

Dirt spills out. How satisfying. You could probably pick up the whole plant.

>l
Open-plan office
A large room with narrow hallways running between grey-walled cubicles.

You can see a potted palm and a printer here.

* * *

>l
Open-plan office
A large room with narrow hallways running between grey-walled cubicles.

You can see a potted palm and a printer here.

* * *

>peck palm
You jab your beak at the potted palm.

Dirt spills out. How satisfying. You could probably pick up the whole plant.

>peck printer
You jab your beak at the printer.
The printer switches on.

Some sheets of paper fly out of the printer and across the room.

[Your score has just gone up by one point.]

>l
Open-plan office
You're in a large open room. Narrow corridors run between grey-walled cubicles. Exits lead east, west, and south.

You can see some sheets of paper, some spilled dirt, a torn-up potted palm, lying sideways, and a dented printer here.

>s
You waddle over with deadly purpose.

Cubicle
An adjustable standing/sitting desk dominates this spacious cubicle. The main office is just to the north.

You can see an adjustable desk (on which are a tattered copy of the book 'Design Patterns' and a laptop) here.

You feel a mighty primal urge to honk, to flap, and to peck things.

>n
You waddle over with deadly purpose.

Open-plan office
You're in a large open room. Narrow corridors run between grey-walled cubicles. Exits lead east, west, and south.

You can see some sheets of paper, some spilled dirt, a torn-up potted palm, lying sideways, and a dented printer here.

>e
You waddle over with deadly purpose.

Office kitchen
This mini kitchen has tasty snacks and bad coffee. The main office is just to the west.

You can see a pod-based coffee maker, a sink, and a purple-haired developer here.

>peck maker
You jab your beak at the pod-based coffee maker.
The pod-based coffee maker switches on.

Coffee sprays out of the coffee maker!

"Horrible goose," yells the enraged developer, chasing you.

[Your score has just gone up by one point.]

* * *

>peck sink
You jab your beak at the sink.
The sink switches on.

The faucet cracks. Water sprays all over!

"Catch it," yells the enraged developer. She trips over you, swearing.

[Your score has just gone up by one point.]

>l
Office kitchen
This mini kitchen has tasty snacks and bad coffee. The main office is just to the west.

You can see a fire alarm, puddles of water, puddles of spilled coffee, a mangled coffee maker, a sink with a broken faucet spraying water everywhere, and a purple-haired developer here.

"Nnnnnnggggg," yells the enraged developer. She flails, knocking her own glasses onto the floor.

>l
Office kitchen
This mini kitchen has tasty snacks and bad coffee. The main office is just to the west.

You can see a fire alarm, puddles of water, puddles of spilled coffee, a mangled coffee maker, a sink with a broken faucet spraying water everywhere, and a purple-haired developer here.

"Nnnnnnggggg," yells the enraged developer.

>peck alarm
You jab your beak at the fire alarm.
The fire alarm switches on.

The glass covering the fire alarm switch breaks.
ooooooOOOOOOooooooo!
The developer panics, opens a cupboard and takes out a fire extinguisher.

The developer slips, dropping the extinguisher.

"Horrible goose," yells the enraged developer, chasing you.

* * *

>l
Open-plan office
You're in a large open room. Narrow corridors run between grey-walled cubicles. Exits lead east, west, and south.

You can see some sheets of paper, some spilled dirt, a torn-up potted palm, lying sideways, and a dented printer here.

>x printer
The printer is currently switched on.

* * *

>peck printer
You jab your beak at the printer.
The printer switches on.

Some sheets of paper fly out of the printer and across the room.

[Your score has just gone up by one point.]

>s
You waddle over with deadly purpose.

Cubicle
An adjustable standing/sitting desk dominates this spacious cubicle. The main office is just to the north.

You can see an adjustable desk (on which are a tattered copy of the book 'Design Patterns' and a laptop) here.

>n
You waddle over with deadly purpose.

Open-plan office
You're in a large open room. Narrow corridors run between grey-walled cubicles. Exits lead east, west, and south.

You can see some sheets of paper, some spilled dirt, a torn-up potted palm, lying sideways, and a dented printer here.

You feel a mighty primal urge to honk, to flap, and to peck things.

>e
You waddle over with deadly purpose.

Office kitchen
This mini kitchen has tasty snacks and bad coffee. The main office is just to the west.

You can see a pod-based coffee maker, a sink, and a purple-haired developer here.

>peck sink
You jab your beak at the sink.
The sink switches on.

The faucet cracks. Water sprays all over!

"Horrible goose," yells the enraged developer, chasing you.

[Your score has just gone up by one point.]

* * *

>peck coffee maker
You jab your beak at the pod-based coffee maker.
The pod-based coffee maker switches on.

Coffee sprays out of the coffee maker!

"Catch it," yells the enraged developer. She trips over you, swearing.

[Your score has just gone up by one point.]

>l
Office kitchen
This mini kitchen has tasty snacks and bad coffee. The main office is just to the west.

You can see a fire alarm, puddles of spilled coffee, puddles of water, a mangled coffee maker, a sink with a broken faucet spraying water everywhere, and a purple-haired developer here.

"Nnnnnnggggg," yells the enraged developer. She flails, knocking her own glasses onto the floor.

>peck alarm
You jab your beak at the fire alarm.
The fire alarm switches on.

The glass covering the fire alarm switch breaks.
ooooooOOOOOOooooooo!
The developer panics, opens a cupboard and takes out a fire extinguisher.

"Catch it," yells the enraged developer.

>w
You waddle over with deadly purpose.

Open-plan office
You're in a large open room. Narrow corridors run between grey-walled cubicles. Exits lead east, west, and south.

You can see some sheets of paper, some spilled dirt, a torn-up potted palm, lying sideways, and a dented printer here.

oooooOOOOOOoooooo BEEP BEEP BEEP
"Catch it," yells the enraged developer.

The purple-haired developer arrives from the east.

>l
Open-plan office
You're in a large open room. Narrow corridors run between grey-walled cubicles. Exits lead east, west, and south.

You can see a purple-haired developer, some sheets of paper, some spilled dirt, a torn-up potted palm, lying sideways, and a dented printer here.

The developer slips, dropping the extinguisher.

"Horrible goose," yells the enraged developer.

* * *

>s
You waddle over with deadly purpose.

Cubicle
An adjustable standing/sitting desk dominates this spacious cubicle. The main office is just to the north.

You can see an adjustable desk (on which are a tattered copy of the book 'Design Patterns' and a laptop) here.

>peck laptop
You jab your beak at the laptop.

Your beak mashes the keys and cracks the screen.

You feel a mighty primal urge to honk, to flap, and to peck things.

[Your score has just gone up by one point.]

>n
You waddle over with deadly purpose.

Open-plan office
You're in a large open room. Narrow corridors run between grey-walled cubicles. Exits lead east, west, and south.

You can see some sheets of paper, some spilled dirt, a torn-up potted palm, lying sideways, and a dented printer here.

* * *

>l
Office kitchen
This mini kitchen has tasty snacks and bad coffee. The main office is just to the west.

You can see a fire alarm, puddles of water, puddles of spilled coffee, a mangled coffee maker, a sink with a broken faucet spraying water everywhere, and a purple-haired developer here.

"Nnnnnnggggg," yells the enraged developer. She flails, knocking her own glasses onto the floor.

>peck alarm
You jab your beak at the fire alarm.
The fire alarm switches on.

The glass covering the fire alarm switch breaks.
ooooooOOOOOOooooooo!
The developer panics, opens a cupboard and takes out a fire extinguisher.

oooooOOOOOOoooooo BEEP BEEP BEEP
"Nnnnnnggggg," yells the enraged developer.

>l
Office kitchen
This mini kitchen has tasty snacks and bad coffee. The main office is just to the west.

You can see a fire alarm, puddles of water, puddles of spilled coffee, a mangled coffee maker, a sink with a broken faucet spraying water everywhere, and a purple-haired developer here.

"Horrible goose," yells the enraged developer. She trips over you, swearing.

>w
You waddle over with deadly purpose.

Open-plan office
You're in a large open room. Narrow corridors run between grey-walled cubicles. Exits lead east, west, and south.

You can see some sheets of paper, some spilled dirt, a torn-up potted palm, lying sideways, and a dented printer here.

oooooOOOOOOoooooo BEEP BEEP BEEP
"Nnnnnnggggg," yells the enraged developer. She trips over you, swearing.

The purple-haired developer arrives from the east.

>l
Open-plan office
You're in a large open room. Narrow corridors run between grey-walled cubicles. Exits lead east, west, and south.

You can see a purple-haired developer, some sheets of paper, some spilled dirt, a torn-up potted palm, lying sideways, and a dented printer here.

The developer slips, dropping the extinguisher.

"Horrible goose," yells the enraged developer. She flails, knocking her own glasses onto the floor.

>showme
Open-plan office - room
    fire extinguisher - device
    purple-haired developer - person
        cup of coffee
    yourself - person
    sheets of paper
    spilled dirt
    torn-up potted palm, lying sideways
    dented printer - device

>peck extinguisher
You jab your beak at the fire extinguisher.
The fire extinguisher switches on.

Nasty-smelling foam spews out of the extinguisher, coating the walls.

oooooOOOOOOoooooo BEEP BEEP BEEP
"Nnnnnnggggg," yells the enraged developer. She flails, knocking her own glasses onto the floor.

>l
Open-plan office
You're in a large open room. Narrow corridors run between grey-walled cubicles. Exits lead east, west, and south.

You can see a fire extinguisher rolling around as it sprays foam everywhere, a purple-haired developer, some sheets of paper, some spilled dirt, a torn-up potted palm, lying sideways, and a dented printer here.

"Catch it," yells the enraged developer, chasing you.

>take palm
You stretch out your neck, biting and gnashing.

You grab the torn-up potted palm, lying sideways with your powerful beak.

oooooOOOOOOoooooo BEEP BEEP BEEP
"Horrible goose," yells the enraged developer, chasing you.

[Your score has just gone up by one point.]

>x self
You're large, you're white, and you're waddling.

"Catch it," yells the enraged developer.

>i
You are carrying: 
  a torn-up potted palm tree (in your beak)

oooooOOOOOOoooooo BEEP BEEP BEEP
"Horrible goose," yells the enraged developer. She trips over you, swearing.

>honk
HMMMMMNNNNK!!!
You suddenly remember that your beak is full of stuff.

Startled, a hapless office worker looks up in alarm.

"Nnnnnnggggg," yells the enraged developer.

>honk
HMMMMMNNNNK!!!
You suddenly remember that your beak is full of stuff.

A person near you jumps in fear.

oooooOOOOOOoooooo BEEP BEEP BEEP
"Catch it," yells the enraged developer, chasing you.

>drop tree
Dropped.

"Catch it," yells the enraged developer. She flails, knocking her own glasses onto the floor.

>drop plant
The torn-up potted palm tree is already here.

oooooOOOOOOoooooo BEEP BEEP BEEP
"Horrible goose," yells the enraged developer. She trips over you, swearing.

>i
You are carrying nothing.

"Horrible goose," yells the enraged developer, chasing you.

>take palm
You stretch out your neck, biting and gnashing.

You grab the torn-up potted palm tree with your powerful beak.

Taken.

oooooOOOOOOoooooo BEEP BEEP BEEP
"Horrible goose," yells the enraged developer. She flails, knocking her own glasses onto the floor.

>i
You are carrying: 
  a torn-up potted palm tree (in your beak)

"Horrible goose," yells the enraged developer, chasing you.

>drop tree
Dropped.

oooooOOOOOOoooooo BEEP BEEP BEEP
"Nnnnnnggggg," yells the enraged developer. She flails, knocking her own glasses onto the floor.

>l
Open-plan office
You're in a large open room. Narrow corridors run between grey-walled cubicles. Exits lead east, west, and south.

You can see a torn-up potted palm tree, some spilled dirt, a fire extinguisher rolling around as it sprays foam everywhere, a purple-haired developer, some sheets of paper, and a dented printer here.

"Nnnnnnggggg," yells the enraged developer.

>take extinguisher
You stretch out your neck, biting and gnashing.

You grab the fire extinguisher rolling around as it sprays foam everywhere with your powerful beak.

Taken.

oooooOOOOOOoooooo BEEP BEEP BEEP
"Catch it," yells the enraged developer. She trips over you, swearing.

>i
You are carrying: 
  a fire extinguisher rolling around as it sprays foam everywhere (in your beak)

"Nnnnnnggggg," yells the enraged developer, chasing you.

>n
You waddle over with deadly purpose.

You can't go that way.

oooooOOOOOOoooooo BEEP BEEP BEEP
"Catch it," yells the enraged developer, chasing you.

>w
You waddle over with deadly purpose.

Conference room
A large board room with chairs arranged around a central table. Through the open door, you can see the main office to the east.

You can see a project manager, an ipad, and a video camera here.

"Nnnnnnggggg," yells the enraged developer.

The purple-haired developer arrives from the east.

>drop all
(the fire extinguisher rolling around as it sprays foam everywhere)
Dropped.

oooooOOOOOOoooooo BEEP BEEP BEEP
"Catch it," yells the enraged developer.

>l
Conference room
A large board room with chairs arranged around a central table. Through the open door, you can see the main office to the east.

You can see a fire extinguisher rolling around as it sprays foam everywhere, a purple-haired developer, a project manager, an ipad, and a video camera here.

"Nnnnnnggggg," yells the enraged developer. She trips over you, swearing.

>peck manager
You jab your beak at the project manager.

You peck her in the butt, feeling a deep sense of satisfaction.
"OUCH!!! HEY!!!"
The project manager leaps up from her chair!

oooooOOOOOOoooooo BEEP BEEP BEEP
"Catch it," yells the enraged developer.
"What the heck," shrieks the manager, lurching forward.

[Your score has just gone up by one point.]

>l
Conference room
A large board room with chairs arranged around a central table. Through the open door, you can see the main office to the east.

You can see a fire extinguisher rolling around as it sprays foam everywhere, a purple-haired developer, a flustered manager, an ipad, and a video camera here.

"Catch it," yells the enraged developer, chasing you.
"My meeting," shrieks the manager. She falls over a chair.

>peck ipad
You jab your beak at the ipad.

A huge picture of a plump goose fills the conference room screen.
The conference call participants all start talking at once!
Someone yells, "STOP THAT GOOSE!" and starts to chase you!

oooooOOOOOOoooooo BEEP BEEP BEEP
"Nnnnnnggggg," yells the enraged developer, chasing you.
"Get it out of here," shrieks the manager.

[Your score has just gone up by one point.]

>l
Conference room
A large board room with chairs arranged around a central table. Through the open door, you can see the main office to the east.

You can see a fire extinguisher rolling around as it sprays foam everywhere, a purple-haired developer, a flustered manager, a battered and scratched ipad, and a video camera here.

"Nnnnnnggggg," yells the enraged developer. She flails, knocking her own glasses onto the floor.
"Aaaaagggghh," shrieks the manager.

* * *

>peck printer
You jab your beak at the printer.
The printer switches on.

Some sheets of paper fly out of the printer and across the room.

[Your score has just gone up by one point.]

>take palm
You stretch out your neck, biting and gnashing.

You grab the torn-up potted palm, lying sideways with your powerful beak.

[Your score has just gone up by one point.]

>s
You waddle over with deadly purpose.

Cubicle
An adjustable standing/sitting desk dominates this spacious cubicle. The main office is just to the north.

You can see an adjustable desk (on which are a tattered copy of the book 'Design Patterns' and a laptop) here.

You feel a mighty primal urge to honk, to flap, and to peck things.

>peck laptop
You jab your beak at the laptop.

Your beak mashes the keys and cracks the screen.

[Your score has just gone up by one point.]

>peck desk
You jab your beak at the adjustable desk.

The desk starts going up and down at random.

[Your score has just gone up by one point.]

>take book
As you open your mouth to bite, you drop some other stuff and immediately forget it.

You grab the tattered copy of the book 'Design Patterns' with your powerful beak.

[Your score has just gone up by one point.]

>w
You waddle over with deadly purpose.

You can't go that way.

>n
You waddle over with deadly purpose.

Open-plan office
You're in a large open room. Narrow corridors run between grey-walled cubicles. Exits lead east, west, and south.

You can see some spilled dirt, some sheets of paper, and a dented printer here.

>w
You waddle over with deadly purpose.

Conference room
A large board room with chairs arranged around a central table. Through the open door, you can see the main office to the east.

You can see a project manager, an ipad, and a video camera here.

>peck manager
You jab your beak at the project manager.

You peck her in the butt, feeling a deep sense of satisfaction.
"OUCH!!! HEY!!!"
The project manager leaps up from her chair!

"What the heck," shrieks the manager, lurching forward.

[Your score has just gone up by one point.]

>peck ipad
You jab your beak at the ipad.

A huge picture of a plump goose fills the conference room screen.
The conference call participants all start talking at once!
Someone yells, "STOP THAT GOOSE!" and starts to chase you!

"My meeting," shrieks the manager. She falls over a chair.

[Your score has just gone up by one point.]

>peck camera
You leap several feet in the air but fail to peck the video camera.

"Get it out of here," shrieks the manager.

>get on chair
You get onto the chair.

"Aaaaagggghh," shrieks the manager, lurching forward.

>peck camera
The camera lens cracks.

You jab your beak at the broken camera, dangling from a frayed cable.

"Get it out of here," shrieks the manager, lurching forward.

[Your score has just gone up by one point.]

>e
You waddle over with deadly purpose.

(first getting off the chair)

Open-plan office
You're in a large open room. Narrow corridors run between grey-walled cubicles. Exits lead east, west, and south.

You can see some spilled dirt, some sheets of paper, and a dented printer here.

"Get it out of here," shrieks the manager, lurching forward.

The flustered manager arrives from the west.

>e
You waddle over with deadly purpose.

Office kitchen
This mini kitchen has tasty snacks and bad coffee. The main office is just to the west.

You can see a pod-based coffee maker, a sink, and a purple-haired developer here.

"Get it out of here," shrieks the manager. She falls over a chair.

The flustered manager arrives from the west.

>peck coffee maker
You jab your beak at the pod-based coffee maker.
The pod-based coffee maker switches on.

Coffee sprays out of the coffee maker!

"Horrible goose," yells the enraged developer, chasing you.
"Aaaaagggghh," shrieks the manager. She falls over a chair.

[Your score has just gone up by one point.]

>peck developer
You jab your beak at the purple-haired developer.

The developer shrieks in rage. She comes at you ready to kill.

Congratulations! You are the most horrible of horrible geese.
This start-up office will never be the same.
You run outside, ready to wreak mayhem on the rest of the world!

* * * * * * * * * * * * * * * * * *

Thanks to Laura Kukulski, Danny O'Brien, Potch, Britta Gustafson, Hannah Diaz, Milo Kim, and Jim Shepard for playtesting.

    *** The End ***

In that game you scored 10 out of a possible 10, in 19 turns.

Would you like to RESTART, RESTORE a saved game, QUIT, or UNDO the last command?

* * *

>peck printer
You jab your beak at the printer.
The printer switches on.

Some sheets of paper fly out of the printer and across the room.

[Your score has just gone up by one point.]

>take plant
You stretch out your neck, biting and gnashing.

You grab the torn-up potted palm, lying sideways with your powerful beak.

[Your score has just gone up by one point.]

>w
You waddle over with deadly purpose.

Conference room
A large board room with chairs arranged around a central table. Through the open door, you can see the main office to the east.

You can see a project manager, an ipad, and a video camera here.

You feel a mighty primal urge to honk, to flap, and to peck things.

>peck manager
You jab your beak at the project manager.

You peck her in the butt, feeling a deep sense of satisfaction.
"OUCH!!! HEY!!!"
The project manager leaps up from her chair!

"What the heck," shrieks the manager, lurching forward.

[Your score has just gone up by one point.]

>honk
HMMMMMNNNNK!!!
You suddenly remember that your beak is full of stuff.

Startled, a hapless office worker looks up in alarm.

"My meeting," shrieks the manager. She falls over a chair.

>drop all
(the torn-up potted palm tree)
Dropped.

"Get it out of here," shrieks the manager.

>honk
HONK!!!!

A person near you jumps in fear.

"Aaaaagggghh," shrieks the manager, lurching forward.

>peck ipad
You jab your beak at the ipad.

A huge picture of a plump goose fills the conference room screen.
The conference call participants all start talking at once!
Someone yells, "STOP THAT GOOSE!" and starts to chase you!

"What the heck," shrieks the manager.

[Your score has just gone up by one point.]

>flap
You flap your wings, menacing everything in the near vicinity.

Everyone in the room starts in surprise.

"My meeting," shrieks the manager.

>flap
You flap your wings, menacing everything in the near vicinity.

One of your powerful wings clubs someone in the elbow.

"What the heck," shrieks the manager, lurching forward.

>l
Conference room
A large board room with chairs arranged around a central table. Through the open door, you can see the main office to the east.

You can see a torn-up potted palm tree, a flustered manager, a battered and scratched ipad, and a video camera here.

"My meeting," shrieks the manager.

>get on chair
You get onto the chair.

"My meeting," shrieks the manager, lurching forward.

>peck camera
The camera lens cracks.

You jab your beak at the broken camera, dangling from a frayed cable.

"What the heck," shrieks the manager. She falls over a chair.

[Your score has just gone up by one point.]

>e
You waddle over with deadly purpose.

(first getting off the chair)

Open-plan office
You're in a large open room. Narrow corridors run between grey-walled cubicles. Exits lead east, west, and south.

You can see some spilled dirt, some sheets of paper, and a dented printer here.

"Aaaaagggghh," shrieks the manager. She falls over a chair.

The flustered manager arrives from the west.

>e
You waddle over with deadly purpose.

Office kitchen
This mini kitchen has tasty snacks and bad coffee. The main office is just to the west.

You can see a pod-based coffee maker, a sink, and a purple-haired developer here.

"My meeting," shrieks the manager. She falls over a chair.

The flustered manager arrives from the west.

>peck maker
You jab your beak at the pod-based coffee maker.
The pod-based coffee maker switches on.

Coffee sprays out of the coffee maker!

"Horrible goose," yells the enraged developer, chasing you.
"My meeting," shrieks the manager.

[Your score has just gone up by one point.]

>peck sink
You jab your beak at the sink.
The sink switches on.

The faucet cracks. Water sprays all over!

"Catch it," yells the enraged developer. She trips over you, swearing.
"Aaaaagggghh," shrieks the manager.

[Your score has just gone up by one point.]

>peck developer
You jab your beak at the purple-haired developer.

The developer shrieks in rage. She comes at you ready to kill.

"Nnnnnnggggg," yells the enraged developer. She flails, knocking her own glasses onto the floor.
"Get it out of here," shrieks the manager, lurching forward.

[Your score has just gone up by one point.]

>l
Office kitchen
This mini kitchen has tasty snacks and bad coffee. The main office is just to the west.

You can see a fire alarm, puddles of spilled coffee, an empty coffee cup, puddles of water, a flustered manager, a mangled coffee maker, a sink with a broken faucet spraying water everywhere, and a wet, scalded developer here.

"Catch it," yells the enraged developer.
"What the heck," shrieks the manager. She falls over a chair.

>peck alarm
You jab your beak at the fire alarm.
The fire alarm switches on.

The glass covering the fire alarm switch breaks.
ooooooOOOOOOooooooo!
The developer panics, opens a cupboard and takes out a fire extinguisher.

"Horrible goose," yells the enraged developer. She trips over you, swearing.
"Get it out of here," shrieks the manager.

[Your score has just gone up by one point.]

>l
Office kitchen
This mini kitchen has tasty snacks and bad coffee. The main office is just to the west.

You can see a fire alarm, puddles of spilled coffee, an empty coffee cup, puddles of water, a flustered manager, a mangled coffee maker, a sink with a broken faucet spraying water everywhere, and a wet, scalded developer here.

oooooOOOOOOoooooo BEEP BEEP BEEP!

"Catch it," yells the enraged developer, chasing you.
"Aaaaagggghh," shrieks the manager.

>w
You waddle over with deadly purpose.

Open-plan office
You're in a large open room. Narrow corridors run between grey-walled cubicles. Exits lead east, west, and south.

You can see some spilled dirt, some sheets of paper, and a dented printer here.

"Catch it," yells the enraged developer. She flails, knocking her own glasses onto the floor.

The wet, scalded developer arrives from the east.

"What the heck," shrieks the manager, lurching forward.

The flustered manager arrives from the east.

>w
You waddle over with deadly purpose.

Conference room
A large board room with chairs arranged around a central table. Through the open door, you can see the main office to the east.

You can see a torn-up potted palm tree, a battered and scratched ipad, and a broken camera, dangling from a frayed cable here.

oooooOOOOOOoooooo BEEP BEEP BEEP!
The developer slips, dropping the extinguisher.

"Catch it," yells the enraged developer. She flails, knocking her own glasses onto the floor.

The wet, scalded developer arrives from the east.

"Aaaaagggghh," shrieks the manager, lurching forward.

The flustered manager arrives from the east.

>l
Conference room
A large board room with chairs arranged around a central table. Through the open door, you can see the main office to the east.

You can see a flustered manager, a wet, scalded developer, a fire extinguisher, a torn-up potted palm tree, a battered and scratched ipad, and a broken camera, dangling from a frayed cable here.

"Nnnnnnggggg," yells the enraged developer, chasing you.
"Get it out of here," shrieks the manager.

>peck extinguisher
You jab your beak at the fire extinguisher.
The fire extinguisher switches on.

Nasty-smelling foam spews out of the extinguisher, coating the walls.

oooooOOOOOOoooooo BEEP BEEP BEEP!

"Nnnnnnggggg," yells the enraged developer. She trips over you, swearing.
"My meeting," shrieks the manager. She falls over a chair.

[Your score has just gone up by one point.]

>l
Conference room
A large board room with chairs arranged around a central table. Through the open door, you can see the main office to the east.

You can see a flustered manager, a wet, scalded developer, a fire extinguisher rolling around as it sprays foam everywhere, a torn-up potted palm tree, a battered and scratched ipad, and a broken camera, dangling from a frayed cable here.

"Nnnnnnggggg," yells the enraged developer.
"Get it out of here," shrieks the manager, lurching forward.

>e
You waddle over with deadly purpose.

Open-plan office
You're in a large open room. Narrow corridors run between grey-walled cubicles. Exits lead east, west, and south.

You can see some spilled dirt, some sheets of paper, and a dented printer here.

oooooOOOOOOoooooo BEEP BEEP BEEP!

"Nnnnnnggggg," yells the enraged developer, chasing you.

The wet, scalded developer arrives from the west.

"My meeting," shrieks the manager.

The flustered manager arrives from the west.

>s
You waddle over with deadly purpose.

Cubicle
An adjustable standing/sitting desk dominates this spacious cubicle. The main office is just to the north.

You can see an adjustable desk (on which are a tattered copy of the book 'Design Patterns' and a laptop) here.

"Nnnnnnggggg," yells the enraged developer. She trips over you, swearing.

The wet, scalded developer arrives from the north.

"What the heck," shrieks the manager, lurching forward.

The flustered manager arrives from the north.

>peck desk
You jab your beak at the adjustable desk.

The desk starts going up and down at random.

oooooOOOOOOoooooo BEEP BEEP BEEP!

"Catch it," yells the enraged developer.
"What the heck," shrieks the manager.

[Your score has just gone up by one point.]

>peck laptop
You jab your beak at the laptop.

Your beak mashes the keys and cracks the screen.

"Horrible goose," yells the enraged developer. She flails, knocking her own glasses onto the floor.
"Get it out of here," shrieks the manager.

[Your score has just gone up by one point.]

>l
Cubicle
An adjustable standing/sitting desk dominates this spacious cubicle. The main office is just to the north.

You can see a flustered manager, a wet, scalded developer, and a broken adjustable desk (on which are a tattered copy of the book 'Design Patterns' and a broken laptop) here.

oooooOOOOOOoooooo BEEP BEEP BEEP!

"Catch it," yells the enraged developer. She trips over you, swearing.
"Aaaaagggghh," shrieks the manager, lurching forward.

>peck book
You jab your beak at the tattered copy of the book 'Design Patterns'.

Tasty! You could pick up the whole book and carry it around!

"Horrible goose," yells the enraged developer. She flails, knocking her own glasses onto the floor.
"Aaaaagggghh," shrieks the manager, lurching forward.

>take book
You stretch out your neck, biting and gnashing.

You grab the book with the cover torn off with your powerful beak.

oooooOOOOOOoooooo BEEP BEEP BEEP!

Congratulations! You are the most horrible of horrible geese.
This start-up office will never be the same.
You run outside, ready to wreak mayhem on the rest of the world!

* * * * * * * * * * * * * * * * * *

Thanks to playtesters Laura Kukulski, Danny O'Brien, Potch, Britta Gustafson, Hannah Diaz, Milo Kim, and Jim Shepard.

    *** The End ***

In that game you scored 13 out of a possible 13, in 34 turns.

Would you like to RESTART, RESTORE a saved game, QUIT, or UNDO the last command?

* * *

>peck printer
You jab your beak at the printer.
The printer switches on.

Some sheets of paper fly out of the printer and across the room.

[Your score has just gone up by one point.]

>take printer
You jab your beak at it.

You peck the printer

* * *

>peck palm
You jab your beak at the potted palm.

Dirt spills out. How satisfying. You could probably pick up the whole plant.

>take palm
You stretch out your neck, biting and gnashing.

You grab the torn-up potted palm with your powerful beak.

[Your score has just gone up by one point.]

>i
You are carrying: 
  a torn-up potted palm, lying sideways (in your beak)

* * *

>take palm
You stretch out your neck, biting and gnashing.

You grab the torn-up potted palm with your powerful beak.

[Your score has just gone up by one point.]

>l
Open-plan office
A large room with narrow hallways running between grey-walled cubicles.

You can see some spilled dirt and a printer here.

>i
You are carrying: 
  an a torn-up potted palm, lying sideways (in your beak)

* * *

>take palm
You stretch out your neck, biting and gnashing.

You grab the torn-up potted palm with your powerful beak.

[Your score has just gone up by one point.]

>peck printer
You drop the torn-up potted palm tree and jab viciously.

Some sheets of paper fly out of the printer and across the room.

[Your score has just gone up by one point.]

* * *

>peck palm
You jab your beak at the potted palm.

Dirt spills out. How satisfying. You could probably pick up the whole plant.

>take plant
You can't see any such thing.

* * *

Office Goose
An Interactive Fiction by Lizzard
Release 11 / Serial number 191231 / Inform 7 build 6M62 (I6/v6.33 lib 6/12N) SD
It's a beautiful day in the office, and you are a horrible goose.
(If you aren't sure how to play, type "help" and hit enter.)

Open-plan office
You're in a large open room. Narrow corridors run between grey-walled cubicles. Exits lead east, west, and south.

You can see a potted palm and a printer here.

>peck printer
You jab your beak at the printer.
The printer switches on.

Some sheets of paper fly out of the printer and across the room.

[Your score has just gone up by one point.]

>l
Open-plan office
A large room with narrow hallways running between grey-walled cubicles.

You can see some sheets of paper, a potted palm, and a dented printer here.

>l
Open-plan office
A large room with narrow hallways running between grey-walled cubicles.

You can see a potted palm and a printer here.

>i
You are carrying nothing.

* * *

>l
Open-plan office
A large room with narrow hallways running between grey-walled cubicles.

You can see some sheets of paper, a potted palm, and a dented printer here.

>peck printer
You jab your beak at the printer.
The printer switches off.

>peck palm
You jab your beak at the potted palm.

>l
Open-plan office
A large room with narrow hallways running between grey-walled cubicles.

You can see a potted palm and a printer here.

>switch on printer
A sheet of paper flies out of the printer and across the room.

You switch the printer on.

* * *

>l
Open-plan office
A large room with narrow hallways running between grey-walled cubicles.

You can see some sheets of paper, a potted palm, and a dented printer here.

>poke printer
That's not a verb I recognise.

>peck printer
You jab your beak at the dented printer.
The dented printer switches off.

Some sheets of paper fly out of the printer and across the room.

>l
Open-plan office
A large room with narrow hallways running between grey-walled cubicles.

You can see some sheets of paper, a potted palm, and a dented printer here.

>w
You waddle over with deadly purpose.

Conference room
A large board room with chairs arranged around a central table.

You can see a project manager, an ipad, and a video camera here.

>peck ipad
You jab your beak at the ipad.

A huge picture of a honking goose fills the conference room screen.
The conference call participants all start talking at once!
Someone yells, "STOP THAT GOOSE!" and starts to chase you!

>l
Conference room
A large board room with chairs arranged around a central table.

You can see a flustered geek, chasing you around the room., a battered and scratched ipad, and a video camera here.

>l
Conference room
A large board room with chairs arranged around a central table.

You can see a flustered geek, chasing you around the room., a battered and scratched ipad, and a video camera here.

>e
You waddle over with deadly purpose.

Open-plan office
A large room with narrow hallways running between grey-walled cubicles.

You can see some sheets of paper, a potted palm, and a dented printer here.

* * *

>l
Open-plan office
A large room with narrow hallways running between grey-walled cubicles.

You can see some sheets of paper, a potted palm, and a dented printer here.

>showme
Open-plan office - room
    yourself - person
    potted palm
    printer - device

>peck printer
You jab your beak at the printer.

>l
Open-plan office
A large room with narrow hallways running between grey-walled cubicles.

You can see a potted palm and a printer here.

* * *

>peck printer
You jab your beak at the printer.
The printer switches on.

Some sheets of paper fly out of the printer and across the room.

[Your score has just gone up by one point.]

>peck
You must supply a noun.

>printer
That's not a verb I recognise.

>peck printer
I only understood you as far as wanting to peck.

* * *

>peck printer
You jab your beak at the printer.
The printer switches on.

Some sheets of paper fly out of the printer and across the room.

[Your score has just gone up by one point.]

>peck palm
You jab your beak at the potted palm.

Some dirt spills out from the plant pot.

>take palm
You jab your beak at it.

[Your score has just gone up by one point.]

* * *

>peck ipad
You jab your beak at the ipad.

A huge picture of a plump goose fills the conference room screen.
The conference call participants all start talking at once!
Someone yells, "STOP THAT GOOSE!" and starts to chase you!

[Your score has just gone up by one point.]

>i
You are carrying: 
  a torn-up potted palm, lying sideways (in your beak)

>drop palm
Dropped.

* * *

>peck printer
You jab your beak at the printer.
The printer switches on.

Some sheets of paper fly out of the printer and across the room.

[Your score has just gone up by one point.]

>peck printer
You jab your beak at the dented printer.

>l
Open-plan office
You're in a large open room. Narrow corridors run between grey-walled cubicles. Exits lead east, west, and south.

You can see some sheets of paper, a potted palm, and a dented printer here.

>peck palm
You jab your beak at the potted palm.

>l
Open-plan office
A large room with narrow hallways running between grey-walled cubicles.

You can see some spilled dirt, some sheets of paper, an a torn-up potted palm, lying sideways and an A dented printer here.

* * *

>l
Open-plan office
You're in a large open room. Narrow corridors run between grey-walled cubicles. Exits lead east, west, and south.

You can see some sheets of paper, a potted palm, and a dented printer here.

>switch off printer
You feel more like honking, pecking, and flapping, to be honest.

(You feel a mighty primal urge to honk, to flap, and to peck things.)

>l
Open-plan office
You're in a large open room. Narrow corridors run between grey-walled cubicles. Exits lead east, west, and south.

You can see some sheets of paper, a potted palm, and a dented printer here.

>peck paper
You jab your beak at the sheets of paper.

>l
Open-plan office
You're in a large open room. Narrow corridors run between grey-walled cubicles. Exits lead east, west, and south.

You can see some sheets of paper, a potted palm, and a dented printer here.

* * *

>peck printer
You jab your beak at the dented printer.

>peck printer
You jab your beak at the printer.
The printer switches on.

>l
Open-plan office
A large room with narrow hallways running between grey-walled cubicles.

You can see a potted palm and a printer here.

* * *

>take palm
You jab your beak at it.

[Your score has just gone up by one point.]

>e
You waddle over with deadly purpose.

Office kitchen
This mini kitchen has tasty snacks and bad coffee.

You can see a pod-based coffee maker, a sink, and a purple-haired developer here.

>drop palm
Dropped.

>peck coffee maker
You jab your beak at the pod-based coffee maker.
The pod-based coffee maker switches on.

Coffee sprays out of the coffee maker!

[Your score has just gone up by one point.]

>peck developer
You jab your beak at the purple-haired developer.

The developer shrieks in rage. She comes at you ready to kill.

[Your score has just gone up by one point.]

>peck sink
You jab your beak at the sink.
The sink switches on.

The faucet cracks. Water sprays all over!

[Your score has just gone up by one point.]

>w
You waddle over with deadly purpose.

Open-plan office
A large room with narrow hallways running between grey-walled cubicles.

You can see some spilled dirt, some sheets of paper, and a dented printer here.

>w
You waddle over with deadly purpose.

Conference room
A large board room with chairs arranged around a central table.

You can see a project manager, an ipad, and a video camera here.

>peck manager
You jab your beak at the project manager.

You peck her in the butt, feeling a deep sense of satisfaction.
"OUCH!!! HEY!!!"
The project manager leaps up from her chair!

[Your score has just gone up by one point.]

>peck ipad
You jab your beak at the ipad.

A huge picture of a plump goose fills the conference room screen.
The conference call participants all start talking at once!
Someone yells, "STOP THAT GOOSE!" and starts to chase you!

[Your score has just gone up by one point.]

>peck camera
You leap several feet in the air but fail to peck the video camera.

>i
You are carrying nothing.

>e
You waddle over with deadly purpose.

Open-plan office
A large room with narrow hallways running between grey-walled cubicles.

You can see some spilled dirt, some sheets of paper, and a dented printer here.

>s
You waddle over with deadly purpose.

Cubicle
An adjustable standing/sitting desk dominates this spacious cubicle.

You can see an adjustable desk (on which is a tattered copy of Design Patterns) here.

>peck desk
You jab your beak at the adjustable desk.

The desk starts going up and down at random.

[Your score has just gone up by one point.]

>peck book
You jab your beak at the tattered copy of Design Patterns.

>take book
You jab your beak at it.

Congratulations! You are the most horrible of horrible geese.
This start-up office will never be the same.
You run outside, ready to wreak mayhem on the rest of the world!

    *** The End ***

In that game you scored 9 out of a possible 9, in 18 turns.

Would you like to RESTART, RESTORE a saved game, QUIT, or UNDO the last command?

* * *

>peck printer
You jab your beak at the printer.
The printer switches on.

Some sheets of paper fly out of the printer and across the room.

[Your score has just gone up by one point.]

>x printer
The printer is currently switched on.

* * *

Office Goose
An Interactive Fiction by Lizzard
Release 11 / Serial number 191231 / Inform 7 build 6M62 (I6/v6.33 lib 6/12N) SD
It's a beautiful day in the office, and you are a horrible goose.
(If you aren't sure how to play, type "help" and hit enter.)

Open-plan office
You're in a large open room. Narrow corridors run between grey-walled cubicles. Exits lead east, west, and south.

You can see a potted palm and a printer here.

>s
You waddle over with deadly purpose.

Cubicle
An adjustable standing/sitting desk dominates this spacious cubicle. The main office is just to the north.

You can see an adjustable desk (on which are a tattered copy of the book 'Design Patterns' and a laptop) here.

>look laptop
A laptop with several windows open, showing some code.

>read code
 "changesets": 
 "desc": "Bug 1341190 - Remove .popup-anchor visibility rule. r=mconley, a=lizzard\n\nMozReview-Commit-ID: DFMIKMMnLx5"
},
 {
  "desc": "Bug 1348409 - Stop supporting the showDialog argument for window.find. r=mrbkap, a=lizzard\n\nThe dialog functionality of the non-standard window.find API has been broken\nwith e10s since it shipped, and bug 1182569 or bug 1232432 (or both) have\nbroken it for non-e10s.\n\nThis patch remove showDialog support entirely, for both e10s and non-e10s,\nin a more deliberate way. We now ignore the argument.\n\nMozReview-Commit-ID: 1CTzgEkDhHW" 
 },

* * *

>s
You waddle over with deadly purpose.

Cubicle
An adjustable standing/sitting desk dominates this spacious cubicle. The main office is just to the north.

You can see an adjustable desk (on which are a tattered copy of the book 'Design Patterns' and a laptop) here.

>peck book
You jab your beak at the tattered copy of the book 'Design Patterns'.

Tasty! You could pick up the whole book and carry it around!

>eat book
You shred the book into tiny pieces.

>l
Cubicle
An adjustable standing/sitting desk dominates this spacious cubicle. The main office is just to the north.

You can see some little bits of chewed up paper and an adjustable desk (on which is a laptop) here.

(You feel a mighty primal urge to honk, to flap, and to peck things.)

* * *

>s
You waddle over with deadly purpose.

Cubicle
An adjustable standing/sitting desk dominates this spacious cubicle. The main office is just to the north.

You can see an adjustable desk (on which are a tattered copy of the book 'Design Patterns' and a laptop) here.

>peck desk
You jab your beak at the adjustable desk.

The desk starts going up and down at random.

>l
Cubicle
An adjustable standing/sitting desk dominates this spacious cubicle.

You can see a broken adjustable desk (on which is a tattered copy of Design Patterns) here.

>take book
You jab your beak at it.

Taken.

>l
Cubicle
An adjustable standing/sitting desk dominates this spacious cubicle.

You can see a broken adjustable desk here.

* * *

>s
You waddle over with deadly purpose.

Cubicle
An adjustable standing/sitting desk dominates this spacious cubicle. The main office is just to the north.

You can see an adjustable desk (on which are a tattered copy of the book 'Design Patterns' and a laptop) here.

>read code
 "changesets": 
 "desc": "Bug 1341190 - Remove .popup-anchor visibility rule. r=mconley, a=lizzard\n\nMozReview-Commit-ID: DFMIKMMnLx5"
},
 {
  "desc": "Bug 1348409 - Stop supporting the showDialog argument for window.find. r=mrbkap, a=lizzard\n\nThe dialog functionality of the non-standard window.find API has been broken\nwith e10s since it shipped, and bug 1182569 or bug 1232432 (or both) have\nbroken it for non-e10s.\n\nThis patch remove showDialog support entirely, for both e10s and non-e10s,\nin a more deliberate way. We now ignore the argument.\n\nMozReview-Commit-ID: 1CTzgEkDhHW" 
 },

Your tiny, walnut-sized brain hurts a bit. Now you want to bite something.

* * *

>s
You waddle over with deadly purpose.

Cubicle
An adjustable standing/sitting desk dominates this spacious cubicle. The main office is just to the north.

You can see an adjustable desk (on which are a tattered copy of the book 'Design Patterns' and a laptop) here.

>take book
You jab your beak at it.

[Your score has just gone up by one point.]

>throw book
Dropped.

>take book
You jab your beak at it.

Taken.

(You feel a mighty primal urge to honk, to flap, and to peck things.)

>throw book at desk
Futile.

>throw book at laptop
Futile.

* * *

>take book
You jab your beak at it.

[Your score has just gone up by one point.]

>throw book at desk
You thrash your neck around, attempting to fling the book with the cover torn off.
It's too heavy for that.
You drop it.

* * *

>s
You waddle over with deadly purpose.

Cubicle
An adjustable standing/sitting desk dominates this spacious cubicle. The main office is just to the north.

You can see an adjustable desk (on which are a tattered copy of the book 'Design Patterns' and a laptop) here.

>take laptop
You stretch out your neck, biting and gnashing.

You grab the laptop with your powerful beak.

Taken.

>drop laptop
Dropped.

>l
Cubicle
An adjustable standing/sitting desk dominates this spacious cubicle. The main office is just to the north.

You can see a laptop and an adjustable desk (on which is a tattered copy of the book 'Design Patterns') here.

(You feel a mighty primal urge to honk, to flap, and to peck things.)

* * *

>take laptop
You stretch out your neck, biting and gnashing.

You grab the laptop with your powerful beak.

Taken.

>throw laptop
Dropped.

>take laptop
You jab your beak at it.

Taken.

(You feel a mighty primal urge to honk, to flap, and to peck things.)

>throw laptop at desk
You thrash your neck around, attempting to fling the laptop, but throwing isn't your strong point.
Frustrated, you drop the laptop.

>l
Cubicle
An adjustable standing/sitting desk dominates this spacious cubicle. The main office is just to the north.

You can see a laptop and an adjustable desk (on which is a tattered copy of the book 'Design Patterns') here.

>i
You are carrying nothing.

* * *

>s
You waddle over with deadly purpose.

Cubicle
An adjustable standing/sitting desk dominates this spacious cubicle. The main office is just to the north.

You can see an adjustable desk (on which are a tattered copy of the book 'Design Patterns' and a laptop) here.

>x laptop
A laptop with several windows open, showing some code.

>read code
class XULTreeAccessible : public AccessibleWrap {
 public:
 XULTreeAccessible(nsIContent* aContent, DocAccessible* aDoc,
 nsTreeBodyFrame* aTreeframe);

* * *

Office Goose
An Interactive Fiction by Lizzard
Release 11 / Serial number 191231 / Inform 7 build 6M62 (I6/v6.33 lib 6/12N) SD
It's a beautiful day in the office, and you are a horrible goose.
(If you aren't sure how to play, type "help" and hit enter.)

Open-plan office
You're in a large open room. Narrow corridors run between grey-walled cubicles. Exits lead east, west, and south.

You can see a potted palm and a printer here.

>score
You have so far scored 0 out of a possible 13, in 1 turn.

>honk
HONK!!!!

>w
You waddle over with deadly purpose.

Conference room
A large board room with chairs arranged around a central table.

You can see a project manager, an ipad, and a video camera here.

>honk
HONK!!!!

Startled, a hapless office worker looks up in alarm.

>peck ipad
You jab your beak at the ipad.

A huge picture of a plump goose fills the conference room screen.
The conference call participants all start talking at once!
Someone yells, "STOP THAT GOOSE!" and starts to chase you!

[Your score has just gone up by one point.]

>l
Conference room
A large board room with chairs arranged around a central table.

You can see a flustered geek, chasing you around the room., a battered and scratched ipad, and a video camera here.

* * *

Office Goose
An Interactive Fiction by Lizzard
Release 11 / Serial number 191231 / Inform 7 build 6M62 (I6/v6.33 lib 6/12N) SD
It's a beautiful day in the office, and you are a horrible goose.
(If you aren't sure how to play, type "help" and hit enter.)

Open-plan office
You're in a large open room. Narrow corridors run between grey-walled cubicles. Exits lead east, west, and south.

You can see a potted palm and a printer here.

>showme
Open-plan office - room
    yourself - person
    potted palm
    printer - device

>peck palm
You jab your beak at the potted palm.

Dirt spills out. How satisfying. You could probably pick up the whole plant.

>showme
Open-plan office - room
    spilled dirt
    yourself - person
    torn-up potted palm, lying sideways
    printer - device

>l
Open-plan office
A large room with narrow hallways running between grey-walled cubicles. Exits lead east, west, and south.

You can see some spilled dirt, a torn-up potted palm, lying sideways, and a printer here.

* * *

Office Goose
An Interactive Fiction by Lizzard
Release 11 / Serial number 191231 / Inform 7 build 6M62 (I6/v6.33 lib 6/12N) SD
It's a beautiful day in the office, and you are a horrible goose.
(If you aren't sure how to play, type "help" and hit enter.)

Open-plan office
You're in a large open room. Narrow corridors run between grey-walled cubicles. Exits lead east, west, and south.

You can see a potted palm and a printer here.

>switch off printer
You feel more like honking, pecking, and flapping, to be honest.

>switch on printer
A concept somewhat beyond you. Try pecking it instead.

>peck printer
You jab your beak at the printer.
The printer switches on.

Some sheets of paper fly out of the printer and across the room.

[Your score has just gone up by one point.]

>switch off printer
You feel more like honking, pecking, and flapping, to be honest.

(You feel a mighty primal urge to honk, to flap, and to peck things.)

>take paper
You jab your beak at it.

Taken.

>e
You waddle over with deadly purpose.

Office kitchen
This mini kitchen has tasty snacks and bad coffee. The main office is just to the west.

You can see a pod-based coffee maker, a sink, and a purple-haired developer here.

>drop paper
Dropped.

>l
Office kitchen
This mini kitchen has tasty snacks and bad coffee. The main office is just to the west.

You can see some sheets of paper, a pod-based coffee maker, a sink, and a purple-haired developer here.

>peck sink
You jab your beak at the sink.
The sink switches on.

The faucet cracks. Water sprays all over!

"Horrible goose," yells the enraged developer, chasing you.

[Your score has just gone up by one point.]

>l
Office kitchen
This mini kitchen has tasty snacks and bad coffee. The main office is just to the west.

You can see puddles of water, some sheets of paper, a pod-based coffee maker, a sink with a broken faucet spraying water everywhere, and a purple-haired developer here.

"Catch it," yells the enraged developer. She trips over you, swearing.

* * *

Office Goose
An Interactive Fiction by Lizzard
Release 11 / Serial number 191231 / Inform 7 build 6M62 (I6/v6.33 lib 6/12N) SD
It's a beautiful day in the office, and you are a horrible goose.
(If you aren't sure how to play, type "help" and hit enter.)

Open-plan office
You're in a large open room. Narrow corridors run between grey-walled cubicles. Exits lead east, west, and south.

You can see a potted palm and a printer here.

>switch on printer
A concept somewhat beyond you. Try pecking it instead.

>switch off printer
That's already off.

* * *

Office Goose
An Interactive Fiction by Lizzard
Release 11 / Serial number 191231 / Inform 7 build 6M62 (I6/v6.33 lib 6/12N) SD
It's a beautiful day in the office, and you are a horrible goose.
(If you aren't sure how to play, type "help" and hit enter.)

Open-plan office
You're in a large open room. Narrow corridors run between grey-walled cubicles. Exits lead east, west, and south.

You can see a potted palm and a printer here.

>take palm
You stretch out your neck, biting and gnashing.

You grab the potted palm with your powerful beak.

[Your score has just gone up by one point.]

>honk
HMMMMMNNNNK!!!
You suddenly remember that your beak is full of stuff.

>drop palm
Dropped.

>honk
HONK!!!!

(You feel a mighty primal urge to honk, to flap, and to peck things.)

* * *

>take palm
You stretch out your neck, biting and gnashing.

You grab the potted palm with your powerful beak.

[Your score has just gone up by one point.]

>i
You are carrying: 
  a torn-up potted palm, lying sideways (in your beak)

>l
Open-plan office
A large room with narrow hallways running between grey-walled cubicles.

You can see some spilled dirt and a printer here.

* * *

>i
You are carrying: 
  a torn-up potted palm, lying sideways (in your beak)

>s
You waddle over with deadly purpose.

Cubicle
An adjustable standing/sitting desk dominates this spacious cubicle. The main office is just to the north.

You can see an adjustable desk (on which are a tattered copy of the book 'Design Patterns' and a laptop) here.

>i
You are carrying: 
  a torn-up potted palm, lying sideways (in your beak)

(You feel a mighty primal urge to honk, to flap, and to peck things.)

>take laptop
You jab your beak at it, biting and gnashing.

You grab the laptop with your powerful beak.

Taken.

>i
You are carrying: 
  a laptop (in your beak)

>l
Cubicle
An adjustable standing/sitting desk dominates this spacious cubicle. The main office is just to the north.

You can see a torn-up potted palm, lying sideways and an adjustable desk (on which is a tattered copy of the book 'Design Patterns') here.

* * *

>s
You waddle over with deadly purpose.

Cubicle
An adjustable standing/sitting desk dominates this spacious cubicle. The main office is just to the north.

You can see an adjustable desk (on which are a tattered copy of the book 'Design Patterns' and a laptop) here.

>n
You waddle over with deadly purpose.

Open-plan office
A large room with narrow hallways running between grey-walled cubicles.

You can see a printer here.

>e
You waddle over with deadly purpose.

Office kitchen
This mini kitchen has tasty snacks and bad coffee.

You can see a pod-based coffee maker, a sink and a purple-haired developer here.

>w
You waddle over with deadly purpose.

Open-plan office
A large room with narrow hallways running between grey-walled cubicles.

You can see a printer here.

>w
You waddle over with deadly purpose.

Conference room
A large board room with chairs arranged around a central table.

You can see a project manager, an ipad and a video camera here.

>take ipad
You jab your beak at it.

You're carrying too many things already.

* * *

>s
You waddle over with deadly purpose.

Cubicle
An adjustable standing/sitting desk dominates this spacious cubicle. The main office is just to the north.

You can see an adjustable desk (on which are a tattered copy of the book 'Design Patterns' and a laptop) here.

>take laptop
You're carrying too many things already.

(You feel a mighty primal urge to honk, to flap, and to peck things.)

* * *

>i
You are carrying: 
  a torn-up potted palm, lying sideways (in your beak)

>w
You waddle over with deadly purpose.

Conference room
A large board room with chairs arranged around a central table.

You can see a project manager, an ipad and a video camera here.

>take ipad
You jab your beak at it.

Taken.

>l
Conference room
A large board room with chairs arranged around a central table.

You can see a potted palm, a project manager and a video camera here.

>l
Conference room
A large board room with chairs arranged around a central table.

You can see a potted palm, a project manager and a video camera here.

>x palm
You see nothing special about the potted palm.

* * *

>take palm
You stretch out your neck, biting and gnashing.

You grab the potted palm with your powerful beak.

[Your score has just gone up by one point.]

>l
Open-plan office
A large room with narrow hallways running between grey-walled cubicles.

You can see some spilled dirt and a printer here.

>i
You are carrying: 
  an orn-up potted palm, lying sideways (in your beak)

>w
You waddle over with deadly purpose.
Dragging your prize behind you is difficult, but you manage it.

Conference room
A large board room with chairs arranged around a central table.

You can see a project manager, an ipad, and a video camera here.

>i
You are carrying: 
  an orn-up potted palm, lying sideways (in your beak)

* * *

>l
Open-plan office
A large room with narrow hallways running between grey-walled cubicles.

You can see some spilled dirt and a printer here.

>w
You waddle over with deadly purpose.

Conference room
A large board room with chairs arranged around a central table.

You can see a project manager, an ipad and a video camera here.

>e
You waddle over with deadly purpose.

Open-plan office
A large room with narrow hallways running between grey-walled cubicles.

You can see some spilled dirt and a printer here.

>s
You waddle over with deadly purpose.

Cubicle
An adjustable standing/sitting desk dominates this spacious cubicle.

You can see an adjustable desk (on which is a tattered copy of Design Patterns) here.

>take book
You jab your beak at it.

Taken.

>i
You are carrying: 
  a tattered copy of Design Patterns (in your beak)

>l
Cubicle
An adjustable standing/sitting desk dominates this spacious cubicle.

You can see a potted palm and an adjustable desk here.

* * *

>l
Cubicle
An adjustable standing/sitting desk dominates this spacious cubicle.

You can see some little bits of chewed up paper, a tattered copy of Design Patterns, a potted palm and an adjustable desk here.

>peck
You must supply a noun.

>l
Cubicle
An adjustable standing/sitting desk dominates this spacious cubicle.

You can see some little bits of chewed up paper, a tattered copy of Design Patterns, a potted palm and an adjustable desk here.

>peck desk
I only understood you as far as wanting to peck.

>peck palm
I only understood you as far as wanting to peck.

>peck
You must supply a noun.

>peck paper
I only understood you as far as wanting to peck.

* * *

>take palm
You stretch out your neck, biting and gnashing.

You grab the potted palm with your powerful beak.

[Your score has just gone up by one point.]

>peck printer
Some sheets of paper fly out of the printer and across the room.

[Your score has just gone up by one point.]

>l
Open-plan office
You're in a large open room. Narrow corridors run between grey-walled cubicles. Exits lead east, west, and south.

You can see some sheets of paper, a torn-up potted palm tree, some spilled dirt, and a dented printer here.

>i
You are carrying nothing.

You feel a mighty primal urge to honk, to flap, and to peck things.

* * *

>take palm
You stretch out your neck, biting and gnashing.

You grab the potted palm with your powerful beak.

[Your score has just gone up by one point.]

>s
You waddle over with deadly purpose.

Cubicle
An adjustable standing/sitting desk dominates this spacious cubicle. The main office is just to the north.

You can see an adjustable desk (on which are a tattered copy of the book 'Design Patterns' and a laptop) here.

>take laptop
As you open your beak to bite, you drop some other stuff and immediately forget it.

You grab the laptop with your powerful beak.

Taken.

>i
You are carrying nothing.

(You feel a mighty primal urge to honk, to flap, and to peck things.)

>l
Cubicle
An adjustable standing/sitting desk dominates this spacious cubicle. The main office is just to the north.

You can see a laptop and an adjustable desk (on which is a tattered copy of the book 'Design Patterns') here.

* * *

>take palm
You stretch out your neck, biting and gnashing.

You grab the potted palm with your powerful beak.

[Your score has just gone up by one point.]

>throw palm
Dropped.

>showme
Open-plan office - room
    torn-up potted palm, lying sideways
    spilled dirt
    yourself - person
    printer - device

>take palm
You jab your beak at it.

Taken.

>throw palm
Dropped.

(You feel a mighty primal urge to honk, to flap, and to peck things.)

* * *

>throw palm
Dropped.

>take palm
You jab your beak at it.

Taken.

>throw palm at printer
You thrash your neck around, attempting to fling the torn-up potted palm, lying sideways.
It's too heavy for that.

(You feel a mighty primal urge to honk, to flap, and to peck things.)

* * *

>take palm
You stretch out your neck, biting and gnashing.

You grab the potted palm with your powerful beak.

[Your score has just gone up by one point.]

>w
You waddle over with deadly purpose.

Conference room
A large board room with chairs arranged around a central table.

You can see a project manager, an ipad and a video camera here.

* * *

>l
Conference room
A large board room with chairs arranged around a central table.

You can see a potted palm, a project manager and a video camera here.

>i
You are carrying: 
  an ipad (in your beak)

* * *

Office Goose
An Interactive Fiction by Lizzard
Release 11 / Serial number 191231 / Inform 7 build 6M62 (I6/v6.33 lib 6/12N) SD
It's a beautiful day in the office, and you are a horrible goose.
(If you aren't sure how to play, type "help" and hit enter.)

Open-plan office
You're in a large open room. Narrow corridors run between grey-walled cubicles. Exits lead east, west, and south.

You can see a potted palm and a printer here.

>take printer
You jab your face at it, biting and gnashing.

It's too big. Maybe you could peck it instead.

>peck printer
You jab your beak at the printer.
The printer switches on.

Some sheets of paper fly out of the printer and across the room.

[Your score has just gone up by one point.]

>honk
HONK!!!!

* * *

>peck printer
You jab your beak at the printer.
The printer switches on.

Some sheets of paper fly out of the printer and across the room.

[Your score has just gone up by one point.]

>l
Open-plan office
A large room with narrow hallways running between grey-walled cubicles.

You can see a potted palm and a printer here.

>take palm
You jab your beak at it.

>l
Open-plan office
A large room with narrow hallways running between grey-walled cubicles.

You can see some spilled dirt and a printer here.

>i
You are carrying: 
  a potted palm (in your beak)

>w
You waddle over with deadly purpose.
Dragging stuff behind you.

Conference room
A large board room with chairs arranged around a central table.

You can see a project manager, an ipad and a video camera here.

>take ipad
You jab your beak at it.

Taken.

>honk
HONK!!!!

* * *

>flap
You flap your wings, menacing everything in the near vicinity.

>l
Conference room
A large board room with chairs arranged around a central table.

You can see a potted palm, a project manager and a video camera here.

>x palm
A torn up potted plant, on its side with dirt spilling out.

* * *

Office Goose
An Interactive Fiction by Lizzard
Release 11 / Serial number 191231 / Inform 7 build 6M62 (I6/v6.33 lib 6/12N) SD
It's a beautiful day in the office, and you are a horrible goose.
(If you aren't sure how to play, type "help" and hit enter.)

Open-plan office
You're in a large open room. Narrow corridors run between grey-walled cubicles. Exits lead east, west, and south.

You can see a potted palm and a printer here.

>w
You waddle over with deadly purpose.

Conference room
A large board room with chairs arranged around a central table. Through the open door, you can see the main office to the east.

You can see a project manager, an ipad, and a video camera here.

>e
You waddle over with deadly purpose.

Open-plan office
A large room with narrow hallways running between grey-walled cubicles.

You can see a potted palm and a printer here.

* * *

>w
You waddle over with deadly purpose.

Conference room
A large board room with chairs arranged around a central table. Through the open door, you can see the main office to the east.

You can see a project manager, an ipad, and a video camera here.

>get on chair
You get onto the chair.

>l
Conference room (on the chair)
A large board room with chairs arranged around a central table. Through the open door, you can see the main office to the east.

You can see a project manager, an ipad, and a video camera here.

* * *

>get on chair
You get onto the chair.

>peck camera
The camera lens cracks.

You jab your beak at the broken camera, dangling from a frayed cable.

[Your score has just gone up by one point.]

>peck camera
The camera lens cracks.

You jab your beak at the broken camera, dangling from a frayed cable.

You feel a mighty primal urge to honk, to flap, and to peck things.

>down
You waddle over with deadly purpose.

(first getting off the chair)
You can't go that way.

>get on table
You get onto the table.

>peck camera
The camera lens cracks.

You jab your beak at the broken camera, dangling from a frayed cable.

>exit
You get off the table.

Conference room
A large board room with chairs arranged around a central table. Through the open door, you can see the main office to the east.

You can see a project manager, an ipad, and a broken camera, dangling from a frayed cable here.

* * *

>get on chair
You get onto the chair.

>stand on chair
That's not something you can stand on.

* * *

>w
You waddle over with deadly purpose.

Conference room
A large board room with chairs arranged around a central table. Through the open door, you can see the main office to the east.

You can see a project manager, an ipad, and a video camera here.

>peck camera
You leap several feet in the air but fail to peck the video camera.

>get on chair
You get onto the chair.

>peck camera
The camera lens cracks.

You jab your beak at the broken camera, dangling from a frayed cable.

(You feel a mighty primal urge to honk, to flap, and to peck things.)

[Your score has just gone up by one point.]

>e
You waddle over with deadly purpose.

(first getting off the chair)

Open-plan office
You're in a large room with narrow hallways running between grey-walled cubicles. Exits lead east, west, and south.

You can see a potted palm and a printer here.

* * *

>w
You waddle over with deadly purpose.

Conference room
A large board room with chairs arranged around a central table. Through the open door, you can see the main office to the east.

You can see a project manager, an ipad, and a video camera here.

>peck ipad
You jab your beak at the ipad.

A huge picture of a plump goose fills the conference room screen.
The conference call participants all start talking at once!
Someone yells, "STOP THAT GOOSE!" and starts to chase you!

[Your score has just gone up by one point.]

>peck ipad
You jab your beak at the battered and scratched ipad.

* * *

>peck manager
You jab your beak at the project manager.

You peck her in the butt, feeling a deep sense of satisfaction.
"OUCH!!! HEY!!!"
The project manager leaps up from her chair!

"What the heck," shrieks the manager, lurching forward.

[Your score has just gone up by one point.]

>e
You waddle over with deadly purpose.

Open-plan office
A large room with narrow hallways running between grey-walled cubicles. Exits lead east, west, and south.

You can see a potted palm and a printer here.

"My meeting," shrieks the manager. She falls over a chair.

The flustered geek arrives from the west.

>w
You waddle over with deadly purpose.

Conference room
A large board room with chairs arranged around a central table. Through the open door, you can see the main office.

You can see a flustered geek, chasing you around the room, an ipad, and a video camera here.

>l
Conference room
A large board room with chairs arranged around a central table. Through the open door, you can see the main office.

You can see a flustered geek, chasing you around the room, an ipad, and a video camera here.

>peck manager
You jab your beak at the flustered geek, chasing you around the room.

* * *

>peck manager
You jab your beak at the project manager.

You peck her in the butt, feeling a deep sense of satisfaction.
"OUCH!!! HEY!!!"
The project manager leaps up from her chair!

"What the heck," shrieks the manager, lurching forward.

[Your score has just gone up by one point.]

>l
Conference room
A large board room with chairs arranged around a central table. Through the open door, you can see the main office to the east.

You can see a flustered manager, an ipad, and a video camera here.

"My meeting," shrieks the manager. She falls over a chair.

>e
You waddle over with deadly purpose.

Open-plan office
You're in a large open room. Narrow corridors run between grey-walled cubicles. Exits lead east, west, and south.

You can see a potted palm and a printer here.

You feel a mighty primal urge to honk, to flap, and to peck things.

"Get it out of here," shrieks the manager.

The flustered manager arrives from the west.

>e
You waddle over with deadly purpose.

Office kitchen
This mini kitchen has tasty snacks and bad coffee. The main office is just to the west.

You can see a pod-based coffee maker, a sink, and a purple-haired developer here.

"Aaaaagggghh," shrieks the manager, lurching forward.

The flustered manager arrives from the west.

>peck developer
You jab your beak at the purple-haired developer.

The developer shrieks in rage. She comes at you ready to kill.

"Horrible goose," yells the enraged developer, chasing you.
"Get it out of here," shrieks the manager. She falls over a chair.

[Your score has just gone up by one point.]

>l
Office kitchen
This mini kitchen has tasty snacks and bad coffee. The main office is just to the west.

You can see puddles of spilled coffee, an empty coffee cup, a flustered manager, a pod-based coffee maker, a sink, and a wet, scalded developer here.

"Catch it," yells the enraged developer. She trips over you, swearing.
"What the heck," shrieks the manager. She falls over a chair.

>w
You waddle over with deadly purpose.

Open-plan office
You're in a large open room. Narrow corridors run between grey-walled cubicles. Exits lead east, west, and south.

You can see a potted palm and a printer here.

"Nnnnnnggggg," yells the enraged developer. She flails, knocking her own glasses onto the floor.

The wet, scalded developer arrives from the east.

"What the heck," shrieks the manager. She falls over a chair.

The flustered manager arrives from the east.

>l
Open-plan office
You're in a large open room. Narrow corridors run between grey-walled cubicles. Exits lead east, west, and south.

You can see a flustered manager, a wet, scalded developer, a potted palm, and a printer here.

"Horrible goose," yells the enraged developer.
"Get it out of here," shrieks the manager, lurching forward.

>l
Open-plan office
You're in a large open room. Narrow corridors run between grey-walled cubicles. Exits lead east, west, and south.

You can see a flustered manager, a wet, scalded developer, a potted palm, and a printer here.

"Catch it," yells the enraged developer. She trips over you, swearing.
"Get it out of here," shrieks the manager. She falls over a chair.

>l
Open-plan office
You're in a large open room. Narrow corridors run between grey-walled cubicles. Exits lead east, west, and south.

You can see a flustered manager, a wet, scalded developer, a potted palm, and a printer here.

You feel a mighty primal urge to honk, to flap, and to peck things.

"Catch it," yells the enraged developer. She flails, knocking her own glasses onto the floor.
"My meeting," shrieks the manager.

>l
Open-plan office
You're in a large open room. Narrow corridors run between grey-walled cubicles. Exits lead east, west, and south.

You can see a flustered manager, a wet, scalded developer, a potted palm, and a printer here.

"Nnnnnnggggg," yells the enraged developer. She trips over you, swearing.
"My meeting," shrieks the manager. She falls over a chair.

>l
Open-plan office
You're in a large open room. Narrow corridors run between grey-walled cubicles. Exits lead east, west, and south.

You can see a flustered manager, a wet, scalded developer, a potted palm, and a printer here.

"Catch it," yells the enraged developer.
"What the heck," shrieks the manager. She falls over a chair.

>l
Open-plan office
You're in a large open room. Narrow corridors run between grey-walled cubicles. Exits lead east, west, and south.

You can see a flustered manager, a wet, scalded developer, a potted palm, and a printer here.

"Horrible goose," yells the enraged developer. She trips over you, swearing.
"Aaaaagggghh," shrieks the manager. She falls over a chair.

>e
You waddle over with deadly purpose.

Office kitchen
This mini kitchen has tasty snacks and bad coffee. The main office is just to the west.

You can see puddles of spilled coffee, an empty coffee cup, a pod-based coffee maker, and a sink here.

"Catch it," yells the enraged developer. She trips over you, swearing.

The wet, scalded developer arrives from the west.

"What the heck," shrieks the manager, lurching forward.

The flustered manager arrives from the west.

>get snacks
You stretch out your neck, biting and gnashing.

You can't reach it. How infuriating!

"Horrible goose," yells the enraged developer.
"What the heck," shrieks the manager.

* * *

Office Goose
An Interactive Fiction by Lizzard
Release 11 / Serial number 191231 / Inform 7 build 6M62 (I6/v6.33 lib 6/12N) SD
It's a beautiful day in the office, and you are a horrible goose.
(If you aren't sure how to play, type "help" and hit enter.)

Open-plan office
You're in a large open room. Narrow corridors run between grey-walled cubicles. Exits lead east, west, and south.

You can see a potted palm and a printer here.

>x palm
A large indoor plant with luxuriant fronds.
You feel an urge to peck it.

>l
Open-plan office
A large room with narrow hallways running between grey-walled cubicles. Exits lead east, west, and south.

You can see a potted palm and a printer here.

* * *

>i
You are carrying nothing.

>l
Open-plan office
A large room with narrow hallways running between grey-walled cubicles. Exits lead east, west, and south.

You can see a potted palm and a printer here.

(You feel a mighty primal urge to honk, to flap, and to peck things.)

(You feel a mighty primal urge to honk, to flap, and to peck things.)

>e
You waddle over with deadly purpose.

Office kitchen
This mini kitchen has tasty snacks and bad coffee. The main office is just to the east.

You can see a pod-based coffee maker, a sink, and a purple-haired developer here.

>peck developer
You jab your beak at the purple-haired developer.

The developer shrieks in rage. She comes at you ready to kill.

"Horrible goose," yells the enraged developer, chasing you.

[Your score has just gone up by one point.]

>w
You waddle over with deadly purpose.

Open-plan office
A large room with narrow hallways running between grey-walled cubicles. Exits lead east, west, and south.

You can see a potted palm and a printer here.

"Catch it," yells the enraged developer. She trips over you, swearing.

The wet, scalded developer arrives from the east.

>w
You waddle over with deadly purpose.

Conference room
A large board room with chairs arranged around a central table. Through the open door, you can see the main office to the east.

You can see a project manager, an ipad, and a video camera here.

"Nnnnnnggggg," yells the enraged developer.

The wet, scalded developer arrives from the east.

>peck manager
You jab your beak at the project manager.

You peck her in the butt, feeling a deep sense of satisfaction.
"OUCH!!! HEY!!!"
The project manager leaps up from her chair!

"Horrible goose," yells the enraged developer.
"What the heck," shrieks the manager, lurching forward.

[Your score has just gone up by one point.]

>e
You waddle over with deadly purpose.

Open-plan office
A large room with narrow hallways running between grey-walled cubicles. Exits lead east, west, and south.

You can see a potted palm and a printer here.

"Nnnnnnggggg," yells the developer, chasing you.

The purple-haired developer trying to catch you arrives from the west.

"My meeting," shrieks the manager. She falls over a chair.

The flustered geek arrives from the west.

>s
You waddle over with deadly purpose.

Cubicle
An adjustable standing/sitting desk dominates this spacious cubicle. The main office is just to the north.

You can see an adjustable desk (on which are a tattered copy of Design Patterns and a laptop) here.

"Horrible goose," yells the developer.

The purple-haired developer trying to catch you arrives from the north.

"Get it out of here," shrieks the manager.

The flustered geek arrives from the north.

* * *

>x palm
A large indoor plant with luxuriant fronds.
You feel an urge to peck it.

>x printer
This large printer has a ton of options for copying, collating, and stapling.
 What would happen if you pecked it, hard, with your powerful beak?

The printer is currently switched off.

>l
Open-plan office
A large room with narrow hallways running between grey-walled cubicles. Exits lead east, west, and south.

You can see a potted palm and a printer here.

>l
Open-plan office
A large room with narrow hallways running between grey-walled cubicles. Exits lead east, west, and south.

You can see a potted palm and a printer here.

>x plam
You can't see any such thing.

>x palm
A large indoor plant with luxuriant fronds.
You feel an urge to peck it.

(You feel a mighty primal urge to honk, to flap, and to peck things.)

>honk
HONK!!!!

>s
You waddle over with deadly purpose.

Cubicle
An adjustable standing/sitting desk dominates this spacious cubicle. The main office is just to the north.

You can see an adjustable desk (on which are a tattered copy of Design Patterns and a laptop) here.

>peck desk
You jab your beak at the adjustable desk.

The desk starts going up and down at random.

[Your score has just gone up by one point.]

>peck book
You jab your beak at the tattered copy of Design Patterns.

Tasty! You could pick up the whole book and carry it around!

>take book
You jab your beak at it.

[Your score has just gone up by one point.]

* * *

>l
Open-plan office
A large room with narrow hallways running between grey-walled cubicles. Exits lead east, west, and south.

You can see a potted palm and a printer here.

>peck palm
You jab your beak at the potted palm.

Dirt spills out. How satisfying. You could probably pick up the whole plant.

* * *

>e
You waddle over with deadly purpose.

Office kitchen
This mini kitchen has tasty snacks and bad coffee. The main office is just to the east.

You can see a pod-based coffee maker, a sink, and a purple-haired developer here.

>peck sink
You jab your beak at the sink.
The sink switches on.

The faucet cracks. Water sprays all over!

[Your score has just gone up by one point.]

>l
Office kitchen
This mini kitchen has tasty snacks and bad coffee. The main office is just to the east.

You can see puddles of water, a pod-based coffee maker, a sink, and a purple-haired developer here.

* * *

Office Goose
An Interactive Fiction by Lizzard
Release 11 / Serial number 191231 / Inform 7 build 6M62 (I6/v6.33 lib 6/12N) SD
It's a beautiful day in the office, and you are a horrible goose.
(If you aren't sure how to play, type "help" and hit enter.)

Open-plan office
You're in a large open room. Narrow corridors run between grey-walled cubicles. Exits lead east, west, and south.

You can see a potted palm and a printer here.

>x printer
This large printer has a ton of options for copying, collating, and stapling. What would happen if you pecked it, hard, with your powerful beak?

The printer is currently switched off.